A	EI
AM	A m
AM	EI E m
ABANDON	@ b A n d @ n
ABBREVIATION	@ b r i: v i: EI S @ n
ABC	EI b i: s i:
ABDOMEN	A b d @ m @ n
ABIDE	@ b a: I d
ABILITY	@ b I l @ t i:
ABLAZE	@ b l EI z
ABLE	EI b @ l
ABNORMAL	A b n o: m @ l
ABNORMALITY	A b n o: m A l @ t i:
ABOLISH	@ b O l I S
ABOMINABLE	@ b O m n @ b @ l
ABOMINABLE	@ b O m @ n @ b @ l
ABORIGINE	A b @ r I dZ @ n i:
ABORT	@ b o: t
ABORTION	@ b o: S @ n
ABOUT	@ b a: U t
ABOVE	@ b a v
ABRASION	@ b r EI Z @ n
ABROAD	@ b r o: d
ABRUPT	@ b r a p t
ABSCESS	A b s E s
ABSENT	A b s @ n t
ABSENT-MINDED	A b s @ n t m a: I n d @ d
ABSOLUTE	A b s @ l u: t
ABSORB	@ b s o: b
ABSORB	@ b z o: b
ABSTRACT	A b s t r A k t
ABSURD	@ b s @: d
ABSURD	@ b z @: d
ABUSE	@ b j u: z
ACADEMY	@ k A d @ m i:
ACCELERATE	@ k s E l @ r EI t
ACCENT	A k s E n t
ACCEPT	@ k s E p t
ACCESS	A k s E s
ACCIDENT	A k s @ d @ n t
ACCOMMODATE	@ k O m @ d EI t
ACCOMPANY	@ k a m p @ n i:
ACCOMPLICE	@ k a m p l @ s
ACCORD	@ k o: d
ACCORDINGLY	@ k o: d I N l i:
ACCOUNT	@ k a: U n t
ACCOUNTABLE	@ k a: U n t @ b @ l
ACCOUNTANT	@ k a: U n t @ n t
ACCUMULATE	@ k j u: m j @ l EI t
ACCURATE	A k j @ r @ t
ACCUSE	@ k j u: z
ACCUSTOMED	@ k a s t @ m d
ACE	EI s
ACHE	EI k
ACHIEVE	@ tS i: v
ACID	A s @ d
ACKNOWLEDGE	@ k n O l I dZ
ACNE	A k n i:
ACOUSTICS	@ k u: s t I k s
ACQUAINT	@ k w EI n t
ACQUAINTANCE	@ k w EI n t @ n s
ACQUIRE	@ k w a: I@
ACQUIT	@ k w I t
ACRE	EI k @
ACROBAT	A k r @ b A t
ACRONYM	A k r @ n I m
ACROSS	@ k r O s
ACROSS-THE-BOARD	@ k r O s D @ b o: d
ACRYLIC	@ k r I l I k
ACT	EI s i: t i:
ACTION	A k S @ n
ACTIVATE	A k t @ v EI t
ACTIVE	A k t I v
ACTIVITY	A k t I v @ t i:
ACTOR	A k t @
ACTU	EI s i: t i: j u:
ACTUAL	A k tS u: @ l
ACTUALLY	A k tS u: @ l i:
ACTUALLY	A k tS @ l i:
ACUPUNCTURE	A k j @ p a N k tS @
ACUTE	@ k j u: t
ACUTELY	@ k j u: t l i:
AD	EI d i:
ADAMSAPPLE	A d @ m z A p @ l
ADAPT	@ d A p t
ADD	A d
ADDICT	A d I k t
ADDICTED	@ d I k t @ d
ADDITION	@ d I S @ n
ADDITIVE	A d @ t I v
ADDRESS	@ d r E s
ADEQUATE	A d @ k w @ t
ADHESIVE	@ d h i: z I v
ADHESIVE	@ d h i: s I v
ADJACENT	@ dZ EI s @ n t
ADJECTIVE	A dZ E k t I v
ADJECTIVE	A dZ @ k t I v
ADJOURN	@ dZ @: n
ADJUDICATE	@ dZ u: d @ k EI t
ADJUST	@ dZ a s t
ADJUSTMENT	@ dZ a s t m @ n t
ADMIN	A d m I n
ADMINISTRATION	@ d m I n @ s t r EI S @ n
ADMIRE	@ d m a: I@
ADMISSION	@ d m I S @ n
ADMIT	@ d m I t
ADMITTANCE	@ d m I t @ n s
ADOLESCENCE	A d @ l E s @ n s
ADOPT	@ d O p t
ADORE	@ d o:
ADULT	A d a l t
ADULTERY	@ d a l t @ r i:
ADVANCE	@ d v A n s
ADVANCED	@ d v A n s t
ADVANCEMENT	@ d v A n s m @ n t
ADVANTAGE	@ d v A n t I dZ
ADVENTURE	@ d v E n tS @
ADVERSE	A d v @: s
ADVERSITY	@ d v @: s @ t i:
ADVERTISE	A d v @ t a: I z
ADVERTISEMENT	@ d v @: t @ s m @ n t
ADVICE	@ d v a: I s
ADVISABLE	@ d v a: I z @ b @ l
ADVISE	@ d v a: I z
ADVOCATE	A d v @ k EI t
AERIAL	E@ r i: @ l
AEROBICS	@ r @U b I k s
AERODROME	E@ r @ d r @U m
AEROPLANE	E@ r @ p l EI n
AEROSOL	E@ r @ s O l
AFFAIR	@ f E@
AFFECT	@ f E k t
AFFECTATION	A f E k t EI S @ n
AFFECTED	@ f E k t @ d
AFFECTION	@ f E k S @ n
AFFIRM	@ f @: m
AFFIRMATIVE	@ f @: m @ t I v
AFFLUENT	A f l u: @ n t
AFFORD	@ f o: d
AFLOAT	@ f l @U t
AFRAID	@ f r EI d
AFTER	a: f t @
AFTER-EFFECT	a: f t @ r @ f E k t
AFTER-HOURS	a: f t @ r a: U@ z
AFTERLIFE	a: f t @ l a: I f
AFTERNOON	a: f t @ n u: n
AFTERSHAVE	a: f t @ S EI v
AFTERWARDS	a: f t @ w @ d z
AGAIN	@ g E n
AGAINST	@ g E n s t
AGE	EI dZ
AGED	EI dZ d
AGEING	EI dZ I N
AGEISM	EI dZ I z @ m
AGENCY	EI dZ @ n s i:
AGENDA	@ dZ E n d @
AGENT	EI dZ @ n t
AGGRAVATE	A g r @ v EI t
AGGRESSION	@ g r E S @ n
AGGRESSIVE	@ g r E s I v
AGGRO	A g r @U
AGILE	A dZ a: I l
AGITATE	A dZ @ t EI t
AGNOSTIC	A g n O s t I k
AGO	@ g @U
AGONY	A g @ n i:
AGREE	@ g r i:
AGREEMENT	@ g r i: m @ n t
AGRICULTURE	A g r @ k a l tS @
AHEAD	@ h E d
AID	EI d
AIDS	EI d z
AIM	EI m
AIMLESS	EI m l @ s
AIR	E@
AIRFORCE	E@ f o: s
AIRRAID	E@ r EI d
AIRTRAFFICCONTROL	E@ t r A f I k k @ n t r @U l
AIRCON	E@ k O n
AIRCONDITIONING	E@ k @ n d I S @ n I N
AIRCRAFT	E@ k r a: f t
AIRCRAFTCARRIER	E@ k r a: f t k A r i: @
AIRLIFT	E@ l I f t
AIRLINE	E@ l a: I n
AIRMAIL	E@ m EI l
AIRPORT	E@ p o: t
AISLE	a: I l
AJAR	@ dZ a:
ALARM	@ l a: m
ALARMCLOCK	@ l a: m k l O k
ALARMIST	@ l a: m @ s t
ALBUM	A l b @ m
ALCOHOL	A l k @ h O l
ALCOHOLIC	A l k @ h O l I k
ALE	EI l
ALERT	@ l @: t
ALGEBRA	A l dZ @ b r @
ALIAS	EI l i: @ s
ALIBI	A l @ b a: I
ALIEN	EI l i: @ n
ALIENATE	EI l i: @ n EI t
ALIGHT	@ l a: I t
ALIGN	@ l a: I n
ALIKE	@ l a: I k
ALIVE	@ l a: I v
ALKALI	A l k @ l a: I
ALL	o: l
ALLRIGHT	o: l r a: I t
ALLEGE	@ l E dZ
ALLEGIANCE	@ l i: dZ @ n s
ALLEGORY	A l @ g @ r i:
ALLERGY	A l @ dZ i:
ALLEVIATE	@ l i: v i: EI t
ALLEY	A l i:
ALLIANCE	@ l a: I@ n s
ALLOCATE	A l @ k EI t
ALLOT	@ l O t
ALLOW	@ l a: U
ALLOWANCE	@ l a: U@ n s
ALLURE	@ l u: @
ALLY	A l a: I
ALMIGHTY	o: l m a: I t i:
ALMOST	o: l m @U s t
ALONE	@ l @U n
ALONG	@ l O N
ALOUD	@ l a: U d
ALP	A l p
ALP	EI E l p i:
ALPHABET	A l f @ b E t
ALPINE	A l p a: I n
ALREADY	o: l r E d i:
ALRIGHT	o: l r a: I t
ALSO	o: l s @U
ALTAR	O l t @
ALTER	O l t @
ALTERCATION	O l t @ k EI S @ n
ALTERNATE	O l t @ n EI t
ALTERNATE	O l t @: n @ t
ALTERNATIVE	O l t @: n @ t I v
ALTHOUGH	o: l D @U
ALTITUDE	A l t @ t j u: d
ALTOGETHER	o: l t @ g E D @
ALUMINIUM	A l j @ m I n i: @ m
ALUMINIUM	A l j @ m I n j @ m
ALWAYS	o: l w EI z
AMA	EI E m EI
AMALGAMATE	@ m A l g @ m EI t
AMASS	@ m A s
AMATEUR	A m @ t @
AMAZE	@ m EI z
AMBASSADOR	A m b A s @ d @
AMBER	A m b @
AMBIGUOUS	A m b I g j u: @ s
AMBITION	A m b I S @ n
AMBLE	A m b @ l
AMBULANCE	A m b j @ l @ n s
AMBUSH	A m b U S
AMENABLE	@ m E n @ b @ l
AMEND	@ m E n d
AMENITY	@ m E n @ t i:
AMIABLE	EI m i: @ b @ l
AMICABLE	A m I k @ b @ l
AMMONIA	@ m @U n i: @
AMMUNITION	A m j @ n I S @ n
AMNESIA	A m n i: Z @
AMONG	@ m a N
AMOROUS	A m @ r @ s
AMOUNT	@ m a: U n t
AMPLE	A m p @ l
AMPLIFY	A m p l @ f a: I
AMPUTATE	A m p j @ t EI t
AMPUTEE	A m p j @ t i:
AMUSE	@ m j u: z
AMUSEMENT	@ m j u: z m @ n t
AN	A n
ANAEMIA	@ n i: m i: @
ANAESTHETIC	A n @ s T E t I k
ANAL	EI n @ l
ANALGESIC	A n @ l dZ i: z I k
ANALOGY	@ n A l @ dZ i:
ANALYSIS	@ n A l @ s @ s
ANARCHY	A n @ k i:
ANATOMY	@ n A t @ m i:
ANCESTOR	A n s E s t @
ANCHOR	A N k @
ANCHORAGE	A N k @ r I dZ
ANCIENT	EI n S @ n t
AND	A n d
ANECDOTE	A n @ k d @U t
ANGEL	EI n dZ @ l
ANGER	A N g @
ANGLE	A N g @ l
ANGRY	A N g r i:
ANGUISH	A N g w I S
ANIMAL	A n @ m @ l
ANIMATED	A n @ m EI t @ d
ANIMOSITY	A n @ m O s @ t i:
ANKLE	A N k @ l
ANNEX	A n E k s
ANNEXE	A n E k s
ANNIHILATE	@ n a: I@ l EI t
ANNIVERSARY	A n @ v @: s @ r i:
ANNOUNCE	@ n a: U n s
ANNOY	@ n o: I
ANNUAL	A n j u: @ l
ANONYMOUS	@ n O n @ m @ s
ANOTHER	@ n a D @
ANSWER	A n s @
ANT	A n t
ANTAGONISE	A n t A g @ n a: I z
ANTAGONISTIC	A n t A g @ n I s t I k
ANTENNA	A n t E n @
ANTHEM	A n T @ m
ANTHROPOLOGIST	A n T r @ p O l @ dZ @ s t
ANTI-	A n t i:
ANTIBIOTIC	A n t i: b a: I O t I k
ANTICIPATE	A n t I s @ p EI t
ANTICLOCKWISE	A n t i: k l O k w a: I z
ANTICS	A n t I k s
ANTIDOTE	A n t i: d @U t
ANTIHISTAMINE	A n t i: h I s t @ m i: n
ANTIPATHY	A n t I p @ T i:
ANTIPODES	A n t I p @ d i: z
ANTIQUATED	A n t @ k w EI t @ d
ANTIQUE	A n t i: k
ANTISEPTIC	A n t @ s E p t I k
ANTITHESIS	A n t I T @ s @ s
ANTLER	A n t l @
ANTONYM	A n t @ n I m
ANUS	EI n @ s
ANXIOUS	A N S @ s
ANXIOUS	A N k S @ s
ANY	E n i:
ANYBODY	E n i: b O d i:
ANYHOW	E n i: h a: U
ANYONE	E n i: w a n
ANYTHING	E n i: T I N
ANYWAY	E n i: w EI
ANYWHERE	E n i: w E@
ANZAC	A n z A k
APART	@ p a: t
APARTHEID	@ p a: t EI t
APARTHEID	@ p a: t a: I t
APARTMENT	@ p a: t m @ n t
APARTMENTS	@ p a: t m @ n t s
APATHY	A p @ T i:
APE	EI p
APEX	EI p E k s
APOCALYPSE	@ p O k @ l I p s
APOLOGISE	@ p O l @ dZ a: I z
APOLOGY	@ p O l @ dZ i:
APOSTLE	@ p O s @ l
APOSTROPHE	@ p O s t r @ f i:
APPAL	@ p o: l
APPARATUS	A p @ r a: t @ s
APPARENT	@ p A r @ n t
APPARITION	A p @ r I S @ n
APPEAL	@ p i: l
APPEAR	@ p I@
APPEARANCE	@ p I@ r @ n s
APPEASE	@ p i: z
APPEND	@ p E n d
APPENDICITIS	@ p E n d @ s a: I t @ s
APPENDIX	@ p E n d I k s
APPETISING	A p @ t a: I z I N
APPETITE	A p @ t a: I t
APPLAUSE	@ p l o: z
APPLE	A p @ l
APPLIANCE	@ p l a: I@ n s
APPLICABLE	@ p l I k @ b @ l
APPLICANT	A p l @ k @ n t
APPLY	@ p l a: I
APPOINT	@ p o: I n t
APPOINTMENT	@ p o: I n t m @ n t
APPRECIATE	@ p r i: S i: EI t
APPREHEND	A p r @ h E n d
APPREHENSION	A p r @ h E n S @ n
APPRENTICE	@ p r E n t @ s
APPROACH	@ p r @U tS
APPROACHABLE	@ p r @U tS @ b @ l
APPROPRIATE	@ p r @U p r i: @ t
APPROVAL	@ p r u: v @ l
APPROVE	@ p r u: v
APPROXIMATE	@ p r O k s @ m @ t
APRIL	EI p r @ l
APRON	EI p r @ n
APT	A p t
APTITUDE	A p t @ tS u: d
AQUARIUM	@ k w E@ r i: @ m
ARABIC	A r @ b I k
ARBITRARY	a: b @ t r @ r i:
ARBITRATION	a: b @ t r EI S @ n
ARC	a: k
ARCADE	a: k EI d
ARCH	a: tS
ARCHAEOLOGIST	a: k i: O l @ dZ @ s t
ARCHAIC	a: k EI I k
ARCHITECT	a: k @ t E k t
ARCTICCIRCLE	a: k t I k s @: k @ l
ARDUOUS	a: dZ u: @ s
ARE	a:
AREA	E@ r i: @
ARENA	@ r i: n @
ARGUABLE	a: g j u: @ b @ l
ARGUE	a: g j u:
ARGUMENT	a: g j @ m @ n t
ARISE	@ r a: I z
ARISTOCRACY	A r @ s t O k r @ s i:
ARITHMETIC	@ r I T m @ t I k
ARK	a: k
ARM	a: m
ARMCHAIR	a: m tS E@
ARMED	a: m d
ARMFUL	a: m f U l
ARMHOLE	a: m h @U l
ARMISTICE	a: m @ s t @ s
ARMOUR	a: m @
ARMPIT	a: m p I t
ARMY	a: m i:
AROMA	@ r @U m @
AROUND	@ r a: U n d
AROUSAL	@ r a: U z @ l
AROUSE	@ r a: U z
ARRANGE	@ r EI n dZ
ARRANGEMENT	@ r EI n dZ m @ n t
ARRAY	@ r EI
ARREST	@ r E s t
ARRIVAL	@ r a: I v @ l
ARRIVE	@ r a: I v
ARROGANT	A r @ g @ n t
ARROW	A r @U
ARSE	a: s
ARSENAL	a: s @ n @ l
ARSENIC	a: s @ n I k
ARSON	a: s @ n
ART	a: t
ARTUNION	a: t j u: n j @ n
ARTERY	a: t @ r i:
ARTHRITIS	a: T r a: I t @ s
ARTICLE	a: t I k @ l
ARTIFICIAL	a: t @ f I S @ l
ARTIST	a: t @ s t
ARVO	a: v @U
AS	A z
ASBESTOS	@ s b E s t @ s
ASCEND	@ s E n d
ASCENT	@ s E n t
ASCERTAIN	A s @ t EI n
ASH	A S
ASHAMED	@ S EI m d
ASIDE	@ s a: I d
ASK	a: s k
ASLEEP	@ s l i: p
ASPARAGUS	@ s p A r @ g @ s
ASPECT	A s p E k t
ASPHALT	A S f E l t
ASPIRE	@ s p a: I@
ASPIRIN	A s p r @ n
ASS	A s
ASSASSIN	@ s A s @ n
ASSASSINATE	@ s A s @ n EI t
ASSAULT	@ s O l t
ASSEMBLE	@ s E m b @ l
ASSEMBLY	@ s E m b l i:
ASSENT	@ s E n t
ASSERT	@ s @: t
ASSERTIVE	@ s @: t I v
ASSESS	@ s E s
ASSET	A s E t
ASSIGN	@ s a: I n
ASSIGNMENT	@ s a: I n m @ n t
ASSIMILATE	@ s I m @ l EI t
ASSIST	@ s I s t
ASSOCIATE	@ s @U s i: EI t
ASSOCIATE	@ s @U S i: EI t
ASSOCIATION	@ s @U s i: EI S @ n
ASSORTMENT	@ s o: t m @ n t
ASSUME	@ s j u: m
ASSURANCE	@ S o: r @ n s
ASSURE	@ S o:
ASTERISK	A s t @ r I s k
ASTHMA	A s m @
ASTONISH	@ s t O n I S
ASTOUND	@ s t a: U n d
ASTRAY	@ s t r EI
ASTROLOGY	@ s t r O l @ dZ i:
ASTRONAUT	A s t r @ n o: t
ASTRONOMY	@ s t r O n @ m i:
ASTUTE	@ s t j u: t
ASYLUM	@ s a: I l @ m
AT	A t
ATE	EI t
ATHEIST	EI T i: @ s t
ATHLETE	A T l i: t
ATLAS	A t l @ s
ATM	EI t i: E m
ATMOSPHERE	A t m @ s f I@
ATOM	A t @ m
ATOMIC	@ t O m I k
ATROCIOUS	@ t r @U S @ s
ATTACH	@ t A tS
ATTACK	@ t A k
ATTAIN	@ t EI n
ATTEMPT	@ t E m p t
ATTEND	@ t E n d
ATTENTION	@ t E n S @ n
ATTIC	A t I k
ATTIRE	@ t a: I@
ATTITUDE	A t @ t j u: d
ATTRACT	@ t r A k t
ATTRACTIVE	@ t r A k t I v
ATTRIBUTE	A t r @ b j u: t
ATTRIBUTE	@ t r I b j u: t
ATYPICAL	EI t I p I k @ l
AUBERGINE	@U b @ Z i: n
AUBURN	o: b @ n
AUCTION	O k S @ n
AUDACIOUS	o: d EI S @ s
AUDIBLE	o: d @ b @ l
AUDIENCE	o: d i: @ n s
AUDIO	o: d i: @U
AUDIT	o: d @ t
AUDITION	o: d I S @ n
AUG	o: g @ s t
AUGUST	o: g @ s t
AUGUST	o: g a s t
AUNT	a: n t
AURA	o: r @
AUSPICIOUS	o: s p I S @ s
AUSTERE	O s t I@
AUSTRALIA	@ s t r EI l i: @
AUSTRALIAN	@ s t r EI l j @ n
AUSTRALIANDEMOCRATS	@ s t r EI l j @ n d E m @ k r A t s
AUSTRALIANLABORPARTY	@ s t r EI l j @ n l EI b @ p a: t i:
AUTHENTIC	o: T E n t I k
AUTHOR	o: T @
AUTHORISE	o: T @ r a: I z
AUTHORITY	o: T O r @ t i:
AUTOBIOGRAPHY	o: t @U b a: I O g r @ f i:
AUTOGRAPH	o: t @ g r A f
AUTOMATIC	o: t @ m A t I k
AUTOMOBILE	o: t @ m @ b i: l
AUTONOMOUS	o: t O n @ m @ s
AUTOPSY	o: t O p s i:
AUTUMN	o: t @ m
AUXILIARY	O g z I l j @ r i:
AVAIL	@ v EI l
AVAILABLE	@ v EI l @ b @ l
AVALANCHE	A v @ l A n tS
AVALANCHE	A v @ l A n S
AVE	A v @ n j u:
AVENGE	@ v E n dZ
AVENUE	A v @ n j u:
AVERAGE	A v r I dZ
AVERSE	@ v @: s
AVERSION	@ v @: Z @ n
AVERT	@ v @: t
AVIATION	EI v i: EI S @ n
AVID	A v @ d
AVOCADO	A v @ k a: d @U
AVOID	@ v o: I d
AWAIT	@ w EI t
AWAKE	@ w EI k
AWAKEN	@ w EI k @ n
AWARD	@ w o: d
AWARE	@ w E@
AWAY	@ w EI
AWE	o:
AWFUL	o: f @ l
AWHILE	@ w a: I l
AWKWARD	o: k w @ d
AWNING	o: n I N
AXE	A k s
AXIS	A k s @ s
AXLE	A k s @ l
B	b i:
BABBLE	b A b @ l
BABY	b EI b i:
BABYSIT	b EI b i: s I t
BACHELOR	b A tS @ l @
BACK	b A k
BACKBONE	b A k b @U n
BACKDATE	b A k d EI t
BACKFIRE	b A k f a: I@
BACKGROUND	b A k g r a: U n d
BACKING	b A k I N
BACKLOG	b A k l O g
BACKSIDE	b A k s a: I d
BACKSTOP	b A k s t O p
BACKSTROKE	b A k s t r @U k
BACKUP	b A k a p
BACKWARD	b A k w @ d
BACKWARDS	b A k w @ d z
BACKYARD	b A k j a: d
BACON	b EI k @ n
BACTERIA	b A k t I@ r i: @
BAD	b A d
BADE	b A d
BADGE	b A dZ
BADGER	b A dZ @
BAFFLE	b A f l
BAG	b A g
BAGGAGE	b A g I dZ
BAHASAINDONESIA	b @ h a: s @ I n d @ n i: Z @
BAIL	b EI l
BAIT	b EI t
BAKE	b EI k
BAKINGPOWDER	b EI k I N p a: U d @
BAKINGSODA	b EI k I N s @U d @
BALANCE	b A l @ n s
BALANCED	b A l @ n s t
BALCONY	b A l k @ n i:
BALD	b o: l d
BALE	b EI l
BALLAST	b A l @ s t
BALLET	b A l EI
BALLOT	b A l @ t
BALLPOINTPEN	b o: l p o: I n t p E n
BALMY	b a: m i:
BAMBOOZLE	b A m b u: z @ l
BAN	b A n
BAND	b A n d
BANDAID	b A n d EI d
BANDICOOT	b A n d i: k u: t
BANDIT	b A n d @ t
BANG	b A N
BANJO	b A n dZ @U
BANK	b A N k
BANKRUPT	b A N k r a p t
BANKSIA	b A N k s i: @
BANNER	b A n @
BANQUET	b A N k w @ t
BAPTISM	b A p t I z @ m
BAR	b a:
BARCODE	b a: k @U d
BARB	b a: b
BARBARIAN	b a: b E@ r i: @ n
BARBECUE	b a: b @ k j u:
BARBER	b a: b @
BARBITURATE	b a: b I tS @ r @ t
BARBITURATE	b a: b I tS U r @ t
BARE	b E@
BARELY	b E@ l i:
BARGAIN	b a: g @ n
BARGE	b a: dZ
BARITONE	b A r @ t @U n
BARK	b a: k
BARN	b a: n
BAROMETER	b @ r O m @ t @
BARRACK	b A r @ k
BARRACKS	b A r @ k s
BARRAGE	b A r a: Z
BARREL	b A r @ l
BARREN	b A r @ n
BARRIER	b A r i: @
BARRISTER	b A r @ s t @
BARROW	b A r @U
BASE	b EI s
BASEBALL	b EI s b o: l
BASEMENT	b EI s m @ n t
BASH	b A S
BASHFUL	b A S f U l
BASIC	b EI s I k
BASIN	b EI s @ n
BASIS	b EI s @ s
BASK	b a: s k
BASKET	b a: s k @ t
BASKETBALL	b a: s k @ t b o: l
BASS	b EI s
BASSINETTE	b A s @ n E t
BASTARD	b a: s t @ d
BAT	b A t
BATCH	b A tS
BATH	b a: T
BATHE	b EI D
BATHERS	b EI D @ z
BATHROOM	b a: T r u: m
BATON	b A t @ n
BATTALION	b @ t A l j @ n
BATTEN	b A t @ n
BATTER	b A t @
BATTLE	b A t @ l
BAULK	b o: k
BAWDY	b o: d i:
BAWL	b o: l
BAY	b EI
BAYONET	b EI @ n E t
BBQ	b a: b @ k j u:
BC	b i: s i:
BE	b i:
BEACH	b i: tS
BEACHINSPECTOR	b i: tS I n s p E k t @
BEACON	b i: k @ n
BEAD	b i: d
BEAK	b i: k
BEAM	b i: m
BEAN	b i: n
BEAR	b E@
BEARD	b I@ d
BEARING	b E@ r I N
BEAST	b i: s t
BEAT	b i: t
BEAUT	b j u: t
BEAUTICIAN	b j u: t I S @ n
BEAUTIFUL	b j u: t @ f @ l
BEAUTY	b j u: t i:
BECAME	b @ k EI m
BECAUSE	b i: k o: z
BECKON	b E k @ n
BECOME	b @ k a m
BECOMING	b @ k a m I N
BED	b E d
BEDDING	b E d I N
BEDRAGGLED	b @ d r A g @ l d
BEDRIDDEN	b E d r I d @ n
BEDROOM	b E d r u: m
BEE	b i:
BEEF	b i: f
BEEN	b i: n
BEER	b I@
BEFORE	b @ f o:
BEFRIEND	b @ f r E n d
BEG	b E g
BEGAN	b @ g A n
BEGIN	b @ g I n
BEGINNER	b @ g I n @
BEGRUDGE	b @ g r a dZ
BEGUN	b @ g a n
BEHALF	b @ h a: f
BEHAVE	b @ h EI v
BEHIND	b @ h a: I n d
BEIGE	b EI Z
BEING	b i: I N
BELATED	b @ l EI t @ d
BELCH	b E l tS
BELIEF	b @ l i: f
BELIEVE	b @ l i: v
BELITTLE	b @ l I t @ l
BELL	b E l
BELLIGERENT	b @ l I dZ @ r @ n t
BELLOW	b E l @U
BELLY	b E l i:
BELLYBUTTON	b E l i: b a t @ n
BELONG	b @ l O N
BELONGINGS	b @ l O N I N z
BELOVED	b @ l a v @ d
BELOW	b @ l @U
BELT	b E l t
BENCH	b E n tS
BEND	b E n d
BENEATH	b @ n i: T
BENEFACTOR	b E n @ f A k t @
BENEFICIAL	b E n @ f I S @ l
BENEFICIARY	b E n @ f I S @ r i:
BENEFIT	b E n @ f @ t
BENEVOLENT	b @ n E v @ l @ n t
BENIGN	b @ n a: I n
BENT	b E n t
BEQUEATH	b @ k w i: D
BEREAVED	b @ r i: v d
BEREFT	b @ r E f t
BERET	b E r EI
BERRY	b E r i:
BERSERK	b @ z @: k
BERTH	b @: T
BESIDE	b @ s a: I d
BESIDES	b @ s a: I d z
BESIEGE	b @ s i: dZ
BEST	b E s t
BESTMAN	b E s t m A n
BET	b E t
BETRAY	b @ t r EI
BETTER	b E t @
BETWEEN	b @ t w i: n
BEVERAGE	b E v r I dZ
BEWARE	b @ w E@
BEWILDERED	b @ w I l d @ d
BEWITCH	b @ w I tS
BEYOND	b @ j O n d
BEYOND	b i: O n d
BIANNUAL	b a: I A n j u: @ l
BIAS	b a: I@ s
BIB	b I b
BIBLE	b a: I b @ l
BIBLIOGRAPHY	b I b l i: O g r @ f i:
BICENTENARY	b a: I s E n t E n @ r i:
BICENTENARY	b a: I s E n t i: n @ r i:
BICENTENNIAL	b a: I s @ n t E n i: @ l
BICENTENNIAL	b a: I s E n t E n i: @ l
BICEPS	b a: I s E p s
BICKER	b I k @
BICYCLE	b a: I s I k @ l
BID	b I d
BIDE	b a: I d
BIENNIAL	b a: I E n i: @ l
BIFOCALS	b a: I f @U k @ l z
BIG	b I g
BIGAMY	b I g @ m i:
BIGGIE	b I g i:
BIGHT	b a: I t
BIGOT	b I g @ t
BIKE	b a: I k
BIKINI	b @ k i: n i:
BILE	b a: I l
BILINGUAL	b a: I l I N g w @ l
BILIOUS	b I l j @ s
BILL	b I l
BILLABONG	b I l @ b O N
BILLBOARD	b I l b o: d
BILLET	b I l @ t
BILLIARDS	b I l j @ d z
BILLION	b I l j @ n
BILLOW	b I l @U
BILLY	b I l i:
BIN	b I n
BIND	b a: I n d
BINDI-EYE	b I n d i: a: I
BINGO	b I N g @U
BINOCULARS	b @ n O k j @ l @ z
BIODEGRADABLE	b a: I@ U d @ g r EI d @ b @ l
BIOGRAPHY	b a: I O g r @ f i:
BIOLOGIST	b a: I O l @ dZ @ s t
BIOPSY	b a: I O p s i:
BIRD	b @: d
BIRO	b a: I r @U
BIRTH	b @: T
BIRTHDAY	b @: T d EI
BISCUIT	b I s k @ t
BISECT	b a: I s E k t
BISEXUAL	b a: I s E k S u: @ l
BISHOP	b I S @ p
BISTRO	b I s t r @U
BIT	b I t
BITCH	b I tS
BITE	b a: I t
BITTER	b I t @
BITUMEN	b I tS @ m @ n
BIVOUAC	b I v u: A k
BIZARRE	b @ z a:
BLAB	b l A b
BLACK	b l A k
BLACKSHEEP	b l A k S i: p
BLACKBOARD	b l A k b o: d
BLACKHEAD	b l A k h E d
BLACKMAIL	b l A k m EI l
BLACKOUT	b l A k a: U t
BLACKSMITH	b l A k s m I T
BLADDER	b l A d @
BLADE	b l EI d
BLAME	b l EI m
BLAND	b l A n d
BLANK	b l A N k
BLANKET	b l A N k @ t
BLARE	b l E@
BLASPHEME	b l A s f i: m
BLAST	b l a: s t
BLATANT	b l EI t @ n t
BLAZE	b l EI z
BLAZER	b l EI z @
BLEACH	b l i: tS
BLEAK	b l i: k
BLEARY	b l I@ r i:
BLEAT	b l i: t
BLEED	b l i: d
BLEMISH	b l E m I S
BLEND	b l E n d
BLENDER	b l E n d @
BLESS	b l E s
BLESSING	b l E s I N
BLEW	b l u:
BLIGHT	b l a: I t
BLIND	b l a: I n d
BLINDFOLD	b l a: I n d f @U l d
BLINK	b l I N k
BLINKER	b l I N k @
BLISS	b l I s
BLISTER	b l I s t @
BLISTERING	b l I s t @ r I N
BLITZ	b l I t s
BLIZZARD	b l I z @ d
BLOATED	b l @U t @ d
BLOC	b l O k
BLOCK	b l O k
BLOCKADE	b l O k EI d
BLOCKBUSTER	b l O k b a s t @
BLOKE	b l @U k
BLOND	b l O n d
BLONDE	b l O n d
BLOOD	b l a d
BLOODBATH	b l a d b a: T
BLOODSHED	b l a d S E d
BLOODSHOT	b l a d S O t
BLOODSTREAM	b l a d s t r i: m
BLOODTHIRSTY	b l a d T @: s t i:
BLOODY	b l a d i:
BLOODY-MINDED	b l a d i: m a: I n d @ d
BLOOM	b l u: m
BLOSSOM	b l O s @ m
BLOT	b l O t
BLOUSE	b l a: U z
BLOW	b l @U
BLOWOUT	b l @U a: U t
BLOWTORCH	b l @U t o: tS
BLUBBER	b l a b @
BLUDGE	b l a dZ
BLUDGEON	b l a dZ @ n
BLUE	b l u:
BLUEMETAL	b l u: m E t @ l
BLUEMOVIE	b l u: m u: v i:
BLUE-COLLAR	b l u: k O l @
BLUE-RINGEDOCTOPUS	b l u: r I N d O k t @ p U s
BLUEBIRD	b l u: b @: d
BLUEBOTTLE	b l u: b O t @ l
BLUEPRINT	b l u: p r I n t
BLUES	b l u: z
BLUFF	b l a f
BLUNDER	b l a n d @
BLUNT	b l a n t
BLUR	b l @:
BLURB	b l @: b
BLURT	b l @: t
BLUSH	b l a S
BLUSTER	b l a s t @
BMX	b i: E m E k s
BOARD	b o: d
BOARDER	b o: d @
BOAST	b @U s t
BOAT	b @U t
BOATPEOPLE	b @U t p i: p @ l
BOB	b O b
BOBBIN	b O b @ n
BOBBYPIN	b O b i: p I n
BODICE	b O d @ s
BODY	b O d i:
BODYGUARD	b O d i: g a: d
BOG	b O g
BOGUS	b @U g @ s
BOGY	b @U g i:
BOIL	b o: I l
BOILER	b o: I l @
BOILERSUIT	b o: I l @ s u: t
BOISTEROUS	b o: I s t r @ s
BOLD	b @U l d
BOLSTER	b @U l s t @
BOLT	b @U l t
BOMB	b O m
BOMBARD	b O m b a: d
BOMBSHELL	b O m S E l
BONAFIDE	b @U n @ f a: I d i:
BOND	b O n d
BONE	b @U n
BONFIRE	b O n f a: I@
BONGO	b O N g @U
BONNET	b O n @ t
BONUS	b @U n @ s
BOOB	b u: b
BOOBOOK	b u: b U k
BOOBYPRIZE	b u: b i: p r a: I z
BOOBYTRAP	b u: b i: t r A p
BOOK	b U k
BOOKCASE	b U k k EI s
BOOKKEEPING	b U k k i: p I N
BOOKMAKER	b U k m EI k @
BOOKSTALL	b U k s t o: l
BOOKWORM	b U k w @: m
BOOM	b u: m
BOOMER	b u: m @
BOOMERANG	b u: m @ r A N
BOON	b u: n
BOOR	b o:
BOOST	b u: s t
BOOT	b u: t
BOOTH	b u: D
BOOTY	b u: t i:
BOOZE	b u: z
BORDER	b o: d @
BORDERLINE	b o: d @ l a: I n
BORE	b o:
BORN	b o: n
BORNE	b o: n
BORONIA	b @ r @U n i: @
BOROUGH	b a r @
BORROW	b O r @U
BOSOM	b U z @ m
BOSS	b O s
BOTANIST	b O t @ n @ s t
BOTCH	b O tS
BOTH	b @U T
BOTHER	b O D @
BOTTLE	b O t @ l
BOTTLEBRUSH	b O t @ l b r a S
BOTTLENECK	b O t @ l n E k
BOTTOM	b O t @ m
BOUGH	b a: U
BOUGHT	b o: t
BOULDER	b @U l d @
BOULEVARD	b u: l @ v a: d
BOUNCE	b a: U n s
BOUNCING	b a: U n s I N
BOUNCY	b a: U n s i:
BOUND	b a: U n d
BOUNDARY	b a: U n d r i:
BOUNTY	b a: U n t i:
BOUQUET	b u: k EI
BOUQUET	b @U k EI
BOURGEOIS	b U@ Z w a:
BOUT	b a: U t
BOUTIQUE	b u: t i: k
BOW	b @U
BOWEL	b a: U@ l
BOWEL	b a: U l
BOWERBIRD	b a: U@ b @: d
BOWL	b @U l
BOWLING	b @U l I N
BOWLS	b @U l z
BOWSER	b a: U z @
BOX	b O k s
BOXJELLYFISH	b O k s dZ E l i: f I S
BOXOFFICE	b O k s O f @ s
BOXER	b O k s @
BOY	b o: I
BOYCOTT	b o: I k O t
BOYFRIEND	b o: I f r E n d
BRA	b r a:
BRACE	b r EI s
BRACELET	b r EI s l @ t
BRACKEN	b r A k @ n
BRACKET	b r A k @ t
BRAG	b r A g
BRAID	b r EI d
BRAILLE	b r EI l
BRAIN	b r EI n
BRAINSTORM	b r EI n s t o: m
BRAINWASH	b r EI n w O S
BRAINWAVE	b r EI n w EI v
BRAISE	b r EI z
BRAKE	b r EI k
BRAN	b r A n
BRANCH	b r A n tS
BRAND	b r A n d
BRASH	b r A S
BRASS	b r a: s
BRASSIERE	b r A z i: @
BRASSIERE	b r @ z I@
BRAT	b r A t
BRAVADO	b r @ v a: d @U
BRAVE	b r EI v
BRAWL	b r o: l
BRAWN	b r o: n
BRAZEN	b r EI z @ n
BREACH	b r i: tS
BREAD	b r E d
BREAD-AND-BUTTER	b r E d @ n b a t @
BREADLINE	b r E d l a: I n
BREADTH	b r E d T
BREADWINNER	b r E d w I n @
BREAK	b r EI k
BREAK-IN	b r EI k I n
BREAKABLE	b r EI k @ b @ l
BREAKDOWN	b r EI k d a: U n
BREAKFAST	b r E k f @ s t
BREAKTHROUGH	b r EI k T r u:
BREAM	b r I m
BREAST	b r E s t
BREASTSTROKE	b r E s t s t r @U k
BREATH	b r E T
BREATHTEST	b r E T t E s t
BREATHALYSER	b r E T @ l a: I z @
BREATHE	b r i: D
BREATHTAKING	b r E T t EI k I N
BREED	b r i: d
BREEZE	b r i: z
BREEZY	b r i: z i:
BREVITY	b r E v @ t i:
BREW	b r u:
BREWERY	b r u: @ r i:
BRIBE	b r a: I b
BRICK	b r I k
BRICK-VENEER	b r I k v @ n I@
BRICKIE	b r I k i:
BRICKLAYER	b r I k l EI @
BRIDE	b r a: I d
BRIDEGROOM	b r a: I d g r u: m
BRIDESMAID	b r a: I d z m EI d
BRIDGE	b r I dZ
BRIDLE	b r a: I d @ l
BRIEF	b r i: f
BRIEFCASE	b r i: f k EI s
BRIGHT	b r a: I t
BRILLIANT	b r I l j @ n t
BRIM	b r I m
BRINE	b r a: I n
BRING	b r I N
BRINK	b r I N k
BRISK	b r I s k
BRISTLE	b r I s @ l
BRITTLE	b r I t @ l
BROACH	b r @U tS
BROAD	b r o: d
BROAD-MINDED	b r o: d m a: I n d @ d
BROADCAST	b r o: d k a: s t
BROCCOLI	b r O k @ l i:
BROCHURE	b r @U S @
BROKE	b r @U k
BROKEN	b r @U k @ n
BROKER	b r @U k @
BROLGA	b r O l g @
BROLLY	b r O l i:
BRONCHITIS	b r O N k a: I t @ s
BRONZE	b r O n z
BROOCH	b r @U tS
BROOD	b r u: d
BROOM	b r u: m
BROS	b r a D @ z
BROTH	b r O T
BROTHEL	b r O T @ l
BROTHER	b r a D @
BROTHER-IN-LAW	b r a D @ r I n l o:
BROUGHT	b r o: t
BROW	b r a: U
BROWBEAT	b r a: U b i: t
BROWN	b r a: U n
BROWSE	b r a: U z
BRUISE	b r u: z
BRUMBY	b r a m b i:
BRUNCH	b r a n tS
BRUNETTE	b r u: n E t
BRUNT	b r a n t
BRUSH	b r a S
BRUSSELSSPROUT	b r a s @ l z s p r a: U t
BRUTAL	b r u: t @ l
BRUTE	b r u: t
BUBBLE	b a b @ l
BUBBLER	b a b l @
BUCK	b a k
BUCKET	b a k @ t
BUCKLE	b a k @ l
BUCKTOOTH	b a k t u: T
BUD	b a d
BUDDHISM	b U d I z @ m
BUDDY	b a d i:
BUDGE	b a dZ
BUDGERIGAR	b a dZ @ r i: g a:
BUDGET	b a dZ @ t
BUDGIE	b a dZ i:
BUFF	b a f
BUFFER	b a f @
BUFFET	b a f EI
BUFFOON	b @ f u: n
BUG	b a g
BUGBEAR	b a g b E@
BUGGER	b a g @
BUGLE	b j u: g @ l
BUILD	b I l d
BUILDING	b I l d I N
BUILDINGSOCIETY	b I l d I N s @ s a: I@ t i:
BUILT-UPAREA	b I l t a p E@ r i: @
BULB	b a l b
BULGE	b a l dZ
BULK	b a l k
BULL	b U l
BULLBAR	b U l b a:
BULLDOZER	b U l d @U z @
BULLET	b U l @ t
BULLETIN	b U l @ t @ n
BULLION	b U l j @ n
BULLOCK	b U l @ k
BULLSEYE	b U l z a: I
BULLSHIT	b U l S I t
BULLY	b U l i:
BUM	b a m
BUMBLE	b a m b @ l
BUMP	b a m p
BUMPER	b a m p @
BUN	b a n
BUNCH	b a n tS
BUNDLE	b a n d @ l
BUNDY	b a n d i:
BUNG	b a N
BUNGALOW	b a N g @ l @U
BUNGLE	b a N g @ l
BUNION	b a n j @ n
BUNK	b a N k
BUNKER	b a N k @
BUNNY	b a n i:
BUNYIP	b a n j @ p
BUOY	b o: I
BUOYANT	b o: I@ n t
BURBLE	b @: b @ l
BURDEN	b @: d @ n
BUREAU	b j u: r @U
BUREAUCRACY	b j u: r O k r @ s i:
BUREAUCRAT	b j u: r @ k r A t
BURGLAR	b @: g l @
BURIAL	b E r i: @ l
BURL	b @: l
BURLY	b @: l i:
BURN	b @: n
BURNISH	b @: n I S
BURP	b @: p
BURR	b @:
BURROW	b a r @U
BURSAR	b @: s @
BURSARY	b @: s @ r i:
BURST	b @: s t
BURY	b E r i:
BUS	b a s
BUSH	b U S
BUSHBAND	b U S b A n d
BUSHED	b U S t
BUSHFIRE	b U S f a: I@
BUSHIE	b U S i:
BUSHMAN	b U S m @ n
BUSHRANGER	b U S r EI n dZ @
BUSHWALK	b U S w o: k
BUSHWHACKER	b U S w A k @
BUSINESS	b I z n @ s
BUSINESSLIKE	b I z n @ s l a: I k
BUSKER	b a s k @
BUST	b a s t
BUSTARD	b a s t @ d
BUSTLE	b a s @ l
BUSY	b I z i:
BUSYBODY	b I z i: b O d i:
BUT	b a t
BUTANE	b j u: t EI n
BUTCH	b U tS
BUTCHER	b U tS @
BUTCHERBIRD	b U tS @ b @: d
BUTT	b a t
BUTTER	b a t @
BUTTERFLYSTROKE	b a t @ f l a: I s t r @U k
BUTTOCKS	b a t @ k s
BUTTON	b a t @ n
BUTTRESS	b a t r @ s
BUY	b a: I
BUZZ	b a z
BY	b a: I
BY-ELECTION	b a: I @ l E k S @ n
BY-LAW	b a: I l o:
BY-PRODUCT	b a: I p r O d a k t
BYE	b a: I
BYO	b i: w a: I @U
BYPASS	b a: I p a: s
BYSTANDER	b a: I s t A n d @
BYTE	b a: I t
BYWORD	b a: I w @: d
C	s i:
C/O	k E@ r O v
CAB	k A b
CABBAGE	k A b I dZ
CABIN	k A b @ n
CABINET	k A b n @ t
CABLE	k EI b @ l
CACKLE	k A k @ l
CADET	k @ d E t
CADGE	k A dZ
CAESAREANSECTION	s @ z E@ r i: @ n s E k S @ n
CAFE	k A f EI
CAFETERIA	k A f @ t I@ r i: @
CAGE	k EI dZ
CAGEY	k EI dZ i:
CAKE	k EI k
CALAMARI	k A l @ m a: r i:
CALAMITY	k @ l A m @ t i:
CALCIUM	k A l s i: @ m
CALCULATE	k A l k j @ l EI t
CALCULATING	k A l k j @ l EI t I N
CALCULATOR	k A l k j @ l EI t @
CALENDAR	k A l @ n d @
CALF	k a: f
CALL	k o: l
CALLGIRL	k o: l g @: l
CALLOUS	k A l @ s
CALM	k a: m
CALORIE	k A l @ r i:
CAME	k EI m
CAMERA	k A m r @
CAMOUFLAGE	k A m @ f l a: Z
CAMP	k A m p
CAMPAIGN	k A m p EI n
CAMPUS	k A m p @ s
CAN	k A n
CANAL	k @ n A l
CANCEL	k A n s @ l
CANCER	k A n s @
CANDID	k A n d @ d
CANDIDATE	k A n d @ d EI t
CANDLE	k A n d @ l
CANDOUR	k A n d @
CANE	k EI n
CANETOAD	k EI n t @U d
CANINE	k EI n a: I n
CANNABIS	k A n @ b @ s
CANNON	k A n @ n
CANNOT	k A n O t
CANOE	k @ n u:
CANOPY	k A n @ p i:
CANT	k a: n t
CANTEEN	k A n t i: n
CANTER	k A n t @
CANTONESE	k A n t @ n i: z
CANVAS	k A n v @ s
CANYON	k A n j @ n
CAP	k A p
CAPABLE	k EI p @ b @ l
CAPACITY	k @ p A s @ t i:
CAPE	k EI p
CAPITAL	k A p @ t @ l
CAPITALISE	k A p @ t @ l a: I z
CAPITALISM	k A p @ t @ l I z @ m
CAPSICUM	k A p s i: k @ m
CAPSICUM	k A p s @ k @ m
CAPSIZE	k A p s a: I z
CAPSULE	k A p S u: l
CAPTAIN	k A p t @ n
CAPTION	k A p S @ n
CAPTIVATE	k A p t @ v EI t
CAPTIVE	k A p t I v
CAPTIVITY	k A p t I v @ t i:
CAPTURE	k A p tS @
CAR	k a:
CARPARK	k a: p a: k
CARAFE	k @ r a: f
CARAMEL	k A r @ m @ l
CARAT	k A r @ t
CARAVAN	k A r @ v A n
CARBOHYDRATE	k a: b @ h a: I d r EI t
CARBON	k a: b @ n
CARBURETTOR	k a: b j @ r E t @
CARCASS	k a: k @ s
CARCINOGEN	k a: s I n @ dZ @ n
CARD	k a: d
CARDBOARD	k a: d b o: d
CARDIAC	k a: d i: A k
CARDIGAN	k a: d I g @ n
CARDINALNUMBER	k a: d @ n @ l n a m b @
CARE	k E@
CAREER	k @ r I@
CAREFUL	k E@ f @ l
CARELESS	k E@ l @ s
CARESS	k @ r E s
CARETAKER	k E@ t EI k @
CARGO	k a: g @U
CARICATURE	k A r @ k @ tS U@
CARNAGE	k a: n I dZ
CARNIVAL	k a: n @ v @ l
CAROL	k A r @ l
CARPENTER	k a: p @ n t @
CARPET	k a: p @ t
CARRIAGE	k A r I dZ
CARRY	k A r i:
CART	k a: t
CARTILAGE	k a: t @ l I dZ
CARTON	k a: t @ n
CARTOON	k a: t u: n
CARTRIDGE	k a: t r I dZ
CARTS	k a: t s
CARVE	k a: v
CASE	k EI s
CASH	k A S
CASHIER	k A S I@
CASINO	k @ s i: n @U
CASK	k a: s k
CASSEROLE	k A s @ r @U l
CASSETTE	k @ s E t
CAST	k a: s t
CASTE	k a: s t
CASTLE	k a: s @ l
CASTOR	k a: s t @
CASTRATE	k A s t r EI t
CASUAL	k A Z u: @ l
CASUAL	k A Z j u: @ l
CASUALTY	k A Z j u: @ l t i:
CASUALTY	k A Z u: @ l t i:
CASUARINA	k A Z j @ r i: n @
CAT	k A t
CATALOGUE	k A t @ l O g
CATAPULT	k A t @ p a l t
CATARACT	k A t @ r A k t
CATARRH	k @ t a:
CATASTROPHE	k @ t A s t r @ f i:
CATCH	k A tS
CATEGORY	k A t @ g @ r i:
CATEGORY	k A t @ g r i:
CATER	k EI t @
CATHEDRAL	k @ T i: d r @ l
CATTLE	k A t @ l
CAUCUS	k o: k @ s
CAUGHT	k o: t
CAULIFLOWER	k O l i: f l a: U@
CAUSE	k o: z
CAUSEWAY	k o: z w EI
CAUSTIC	k O s t I k
CAUTERISE	k o: t @ r a: I z
CAUTIOUS	k o: S @ s
CAVALRY	k A v @ l r i:
CAVE	k EI v
CAVERN	k A v @ n
CAVITY	k A v @ t i:
CD	s i: d i:
CEASE	s i: s
CEASEFIRE	s i: s f a: I@
CEILING	s i: l I N
CELEBRATE	s E l @ b r EI t
CELEBRATED	s E l @ b r EI t @ d
CELEBRITY	s @ l E b r @ t i:
CELERY	s E l @ r i:
CELIBACY	s E l @ b @ s i:
CELL	s E l
CELLAR	s E l @
CELSIUS	s E l s i: @ s
CEMENT	s @ m E n t
CEMETERY	s E m @ t r i:
CENSOR	s E n s @
CENSURE	s E n S @
CENSUS	s E n s @ s
CENT	s E n t
CENTENARY	s E n t E n @ r i:
CENTENARY	s E n t i: n @ r i:
CENTIGRADE	s E n t @ g r EI d
CENTIMETRE	s E n t @ m i: t @
CENTRAL	s E n t r @ l
CENTRE	s E n t @
CENTURY	s E n tS @ r i:
CERAMIC	s @ r A m I k
CEREAL	s I@ r i: @ l
CEREBRAL	s E r @ b r @ l
CEREMONY	s E r @ m @ n i:
CERTAIN	s @: t @ n
CERTAINLY	s @: t @ n l i:
CERTIFICATE	s @ t I f I k @ t
CERTIFY	s @: t @ f a: I
CERVIX	s @: v I k s
CES	s i: i: E s
CHAFE	tS EI f
CHAIN	tS EI n
CHAINSAW	tS EI n s o:
CHAIR	tS E@
CHAIRMAN	tS E@ m @ n
CHAIRPERSON	tS E@ p @: s @ n
CHALK	tS o: k
CHALLENGE	tS A l @ n dZ
CHAMBER	tS EI m b @
CHAMOIS	S A m i:
CHAMPION	tS A m p i: @ n
CHANCE	tS A n s
CHANGE	tS EI n dZ
CHANNEL	tS A n @ l
CHANT	tS A n t
CHAOS	k EI O s
CHAP	tS A p
CHAPEL	tS A p @ l
CHAPPED	tS A p t
CHAPTER	tS A p t @
CHARACTER	k A r @ k t @
CHARACTERISTIC	k A r @ k t @ r I s t I k
CHARADE	S @ r EI d
CHARADE	S @ r a: d
CHARCOAL	tS a: k @U l
CHARGE	tS a: dZ
CHARISMA	k @ r I z m @
CHARITY	tS A r @ t i:
CHARM	tS a: m
CHART	tS a: t
CHARTER	tS a: t @
CHASE	tS EI s
CHASSIS	S A z i:
CHAT	tS A t
CHATTER	tS A t @
CHAUFFEUR	S @U f @
CHAUVINISM	S @U v @ n I z @ m
CHEAP	tS i: p
CHEAT	tS i: t
CHECK	tS E k
CHECK-UP	tS E k a p
CHECKOUT	tS E k a: U t
CHEEK	tS i: k
CHEER	tS I@
CHEERFUL	tS I@ f U l
CHEESE	tS i: z
CHEF	S E f
CHEMICAL	k E m I k @ l
CHEMIST	k E m @ s t
CHEMISTRY	k E m @ s t r i:
CHEMOTHERAPY	k i: m @U T E r @ p i:
CHEMOTHERAPY	k E m @U T E r @ p i:
CHEQUE	tS E k
CHEQUEBOOK	tS E k b U k
CHERISH	tS E r I S
CHERUB	tS E r @ b
CHESS	tS E s
CHEST	tS E s t
CHEW	tS u:
CHEWINGGUM	tS u: I N g a m
CHIC	S i: k
CHICK	tS I k
CHICKEN	tS I k @ n
CHICKENPOX	tS I k @ n p O k s
CHIEF	tS i: f
CHILD	tS a: I l d
CHILDISH	tS a: I l d I S
CHILL	tS I l
CHILLI	tS I l i:
CHIME	tS a: I m
CHIMNEY	tS I m n i:
CHIN	tS I n
CHINA	tS a: I n @
CHINESE	tS a: I n i: z
CHIP	tS I p
CHIPBOARD	tS I p b o: d
CHIROPRACTOR	k a: I r @ p r A k t @
CHIRP	tS @: p
CHIRPY	tS @: p i:
CHISEL	tS I z @ l
CHLORINE	k l o: r i: n
CHOCOLATE	tS O k l @ t
CHOICE	tS o: I s
CHOIR	k w a: I@
CHOKE	tS @U k
CHOLERA	k O l @ r @
CHOLESTEROL	k @ l E s t @ r O l
CHOOK	tS U k
CHOOSE	tS u: z
CHOP	tS O p
CHOPPY	tS O p i:
CHOPSTICKS	tS O p s t I k s
CHORD	k o: d
CHORE	tS o:
CHOREOGRAPHER	k O r i: O g r @ f @
CHORUS	k o: r @ s
CHOSE	tS @U z
CHOSEN	tS @U z @ n
CHRISTEN	k r I s @ n
CHRISTIANITY	k r I s t i: A n @ t i:
CHRISTMAS	k r I s m @ s
CHRISTMASBUSH	k r I s m @ s b U S
CHROME	k r @U m
CHRONIC	k r O n I k
CHRONOLOGICAL	k r O n @ l O dZ I k @ l
CHUBBY	tS a b i:
CHUCK	tS a k
CHUCKLE	tS a k @ l
CHUNDER	tS a n d @
CHUNK	tS a N k
CHURCH	tS @: tS
CHURN	tS @: n
CHUTE	S u: t
CHUTNEY	tS a t n i:
CIDER	s a: I d @
CIGAR	s @ g a:
CIGARETTE	s I g @ r E t
CINEMA	s I n @ m @
CIRCLE	s @: k @ l
CIRCUIT	s @: k @ t
CIRCULATE	s @: k j @ l EI t
CIRCULATION	s @: k j @ l EI S @ n
CIRCUMCISE	s @: k @ m s a: I z
CIRCUMFERENCE	s @ k a m f @ r @ n s
CIRCUMSTANCE	s @: k @ m s t A n s
CIRCUS	s @: k @ s
CITIZEN	s I t @ z @ n
CITRUS	s I t r @ s
CITY	s I t i:
CIVIC	s I v I k
CIVIL	s I v @ l
CIVILIAN	s @ v I l j @ n
CIVILISATION	s I v @ l a: I z EI S @ n
CIVILISED	s I v @ l a: I z d
CL	k l @U s
CLAIM	k l EI m
CLAIRVOYANT	k l E@ v o: I@ n t
CLAM	k l A m
CLAMBER	k l A m b @
CLAMMY	k l A m i:
CLAMOUR	k l A m @
CLAMP	k l A m p
CLAN	k l A n
CLANDESTINE	k l A n d @ s t a: I n
CLANG	k l A N
CLANGER	k l A N @
CLAP	k l A p
CLARIFY	k l A r @ f a: I
CLARITY	k l A r @ t i:
CLARK	k l a: k
CLASH	k l A S
CLASP	k l A s p
CLASS	k l a: s
CLASSIC	k l A s I k
CLASSIFY	k l A s @ f a: I
CLASSROOM	k l a: s r u: m
CLATTER	k l A t @
CLAUSE	k l o: z
CLAUSTROPHOBIA	k l O s t r @ f @U b i: @
CLAW	k l o:
CLAY	k l EI
CLEAN	k l i: n
CLEAR	k l I@
CLEARANCE	k l I@ r @ n s
CLEARING	k l I@ r I N
CLEARWAY	k l I@ w EI
CLENCH	k l E n tS
CLERGY	k l @: dZ i:
CLERK	k l a: k
CLEVER	k l E v @
CLICH;AAE	k l i: S EI
CLICK	k l I k
CLIENT	k l a: I@ n t
CLIFF	k l I f
CLIMATE	k l a: I m @ t
CLIMAX	k l a: I m A k s
CLIMB	k l a: I m
CLINCH	k l I n tS
CLING	k l I N
CLINIC	k l I n I k
CLIP	k l I p
CLOAK	k l @U k
CLOCK	k l O k
CLOCKWISE	k l O k w a: I z
CLOCKWORK	k l O k w @: k
CLOG	k l O g
CLONE	k l @U n
CLOSE	k l @U z
CLOSE-UP	k l @U s a p
CLOT	k l O t
CLOTH	k l O T
CLOTHE	k l @U D
CLOTHES	k l @U D z
CLOTHING	k l @U D I N
CLOUD	k l a: U d
CLOUDY	k l a: U d i:
CLOUT	k l a: U t
CLOVER	k l @U v @
CLOWN	k l a: U n
CLUB	k l a b
CLUCKY	k l a k i:
CLUE	k l u:
CLUMP	k l a m p
CLUMSY	k l a m z i:
CLUNG	k l a N
CLUSTER	k l a s t @
CLUTCH	k l a tS
CLUTTER	k l a t @
CM	s E n t @ m i: t @
CO	k a m p @ n i:
COACH	k @U tS
COAGULATE	k @U A g j @ l EI t
COAL	k @U l
COALITION	k @U @ l I S @ n
COARSE	k o: s
COAST	k @U s t
COASTLINE	k @U s t l a: I n
COAT	k @U t
COATHANGER	k @U t h A N @
COATING	k @U t I N
COAX	k @U k s
COBBLESTONE	k O b @ l s t @U n
COBWEB	k O b w E b
COCAINE	k @U k EI n
COCK	k O k
COCK-UP	k O k a p
COCKATOO	k O k @ t u:
COCKPIT	k O k p I t
COCKTAIL	k O k t EI l
COCKY	k O k i:
COCOA	k @U k @U
COCONUT	k @U k @ n a t
COD	s i: @U d i:
CODE	k @U d
CODEINE	k @U d i: n
COERCE	k @U @: s
COFFEE	k O f i:
COFFIN	k O f @ n
COG	k O g
COHERENT	k @U h I@ r @ n t
COHESION	k @U h i: Z @ n
COIL	k o: I l
COIN	k o: I n
COINCIDE	k @U @ n s a: I d
COINCIDENCE	k @U I n s @ d @ n s
COKE	k @U k
COLANDER	k O l @ n d @
COLANDER	k a l @ n d @
COLD	k @U l d
COLD-BLOODED	k @U l d b l a d @ d
COLESLAW	k @U l s l o:
COLIC	k O l I k
COLLABORATE	k @ l A b @ r EI t
COLLAPSE	k @ l A p s
COLLAR	k O l @
COLLARBONE	k O l @ b @U n
COLLATERAL	k @ l A t @ r @ l
COLLEAGUE	k O l i: g
COLLECT	k @ l E k t
COLLECTIVE	k @ l E k t I v
COLLECTOR	k @ l E k t @
COLLEGE	k O l I dZ
COLLIDE	k @ l a: I d
COLOGNE	k @ l @U n
COLON	k @U l @ n
COLONEL	k @: n @ l
COLONY	k O l @ n i:
COLOSSAL	k @ l O s @ l
COLOUR	k a l @
COLUMN	k O l @ m
COMA	k @U m @
COMB	k @U m
COMBAT	k O m b A t
COMBINATION	k O m b @ n EI S @ n
COMBINATIONLOCK	k O m b @ n EI S @ n l O k
COMBINE	k @ m b a: I n
COME	k a m
COMEDY	k O m @ d i:
COMET	k O m @ t
COMFORT	k a m f @ t
COMFORTABLE	k a m f t @ b @ l
COMIC	k O m I k
COMMA	k O m @
COMMAND	k @ m A n d
COMMANDO	k @ m A n d @U
COMMEMORATE	k @ m E m @ r EI t
COMMENCE	k @ m E n s
COMMEND	k @ m E n d
COMMENT	k O m E n t
COMMENTARY	k O m @ n t r i:
COMMERCE	k O m @: s
COMMERCIAL	k @ m @: S @ l
COMMISERATE	k @ m I z @ r EI t
COMMISSION	k @ m I S @ n
COMMISSIONER	k @ m I S @ n @
COMMIT	k @ m I t
COMMITMENT	k @ m I t m @ n t
COMMITTEE	k @ m I t i:
COMMODITY	k @ m O d @ t i:
COMMON	k O m @ n
COMMONWEALTH	k O m @ n w E l T
COMMOTION	k @ m @U S @ n
COMMUNAL	k @ m j u: n @ l
COMMUNE	k O m j u: n
COMMUNICATE	k @ m j u: n @ k EI t
COMMUNICATION	k @ m j u: n @ k EI S @ n
COMMUNISM	k O m j @ n I z @ m
COMMUNITY	k @ m j u: n @ t i:
COMMUTE	k @ m j u: t
COMPACT	k O m p A k t
COMPACTDISC	k O m p A k t d I s k
COMPANION	k @ m p A n j @ n
COMPANY	k a m p @ n i:
COMPARATIVE	k @ m p A r @ t I v
COMPARE	k @ m p E@
COMPARISON	k @ m p A r @ s @ n
COMPARTMENT	k @ m p a: t m @ n t
COMPASS	k a m p @ s
COMPASSION	k @ m p A S @ n
COMPATIBLE	k @ m p A t @ b @ l
COMPEL	k @ m p E l
COMPELLING	k @ m p E l I N
COMPENSATE	k O m p @ n s EI t
COMPERE	k O m p E@
COMPETE	k @ m p i: t
COMPETENT	k O m p @ t @ n t
COMPETITION	k O m p @ t I S @ n
COMPETITIVE	k @ m p E t @ t I v
COMPILE	k @ m p a: I l
COMPLACENT	k @ m p l EI s @ n t
COMPLAIN	k @ m p l EI n
COMPLAINT	k @ m p l EI n t
COMPLEMENT	k O m p l @ m @ n t
COMPLETE	k @ m p l i: t
COMPLEX	k O m p l E k s
COMPLEXION	k @ m p l E k S @ n
COMPLICATED	k O m p l @ k EI t @ d
COMPLIMENT	k O m p l @ m @ n t
COMPLIMENTARY	k O m p l @ m E n t r i:
COMPLY	k @ m p l a: I
COMPONENT	k @ m p @U n @ n t
COMPOSE	k @ m p @U z
COMPOST	k O m p O s t
COMPOUND	k O m p a: U n d
COMPREHEND	k O m p r @ h E n d
COMPRESS	k @ m p r E s
COMPRISE	k @ m p r a: I z
COMPROMISE	k O m p r @ m a: I z
COMPULSION	k @ m p a l S @ n
COMPULSORY	k @ m p a l s @ r i:
COMPUTE	k @ m p j u: t
COMPUTER	k @ m p j u: t @
COMRADE	k O m r EI d
CON	k O n
CONCAVE	k O n k EI v
CONCEAL	k @ n s i: l
CONCEDE	k @ n s i: d
CONCEIT	k @ n s i: t
CONCEITED	k @ n s i: t @ d
CONCEIVABLE	k @ n s i: v @ b @ l
CONCEIVE	k @ n s i: v
CONCENTRATE	k O n s @ n t r EI t
CONCEPT	k O n s E p t
CONCEPTION	k @ n s E p S @ n
CONCERN	k @ n s @: n
CONCERNING	k @ n s @: n I N
CONCERT	k O n s @ t
CONCESSION	k @ n s E S @ n
CONCILIATION	k @ n s I l i: EI S @ n
CONCISE	k @ n s a: I s
CONCLUDE	k @ N k l u: d
CONCLUDE	k @ n k l u: d
CONCRETE	k O N k r i: t
CONCUR	k @ n k @:
CONCUR	k @ N k @:
CONCURRENT	k @ N k a r @ n t
CONCURRENT	k @ n k a r @ n t
CONCUSSION	k @ n k a S @ n
CONCUSSION	k @ N k a S @ n
CONDEMN	k @ n d E m
CONDENSATION	k O n d E n s EI S @ n
CONDENSATION	k O n d @ n s EI S @ n
CONDENSE	k @ n d E n s
CONDESCEND	k O n d @ s E n d
CONDITION	k @ n d I S @ n
CONDITIONED	k @ n d I S @ n d
CONDOM	k O n d O m
CONDONE	k @ n d @U n
CONDUCT	k @ n d a k t
CONE	k @U n
CONFECTIONERY	k @ n f E k S @ n r i:
CONFER	k @ n f @:
CONFERENCE	k O n f r @ n s
CONFESS	k @ n f E s
CONFIDE	k @ n f a: I d
CONFIDENCE	k O n f @ d @ n s
CONFIDENT	k O n f @ d @ n t
CONFIDENTIAL	k O n f @ d E n S @ l
CONFINE	k @ n f a: I n
CONFIRM	k @ n f @: m
CONFISCATE	k O n f @ s k EI t
CONFLICT	k @ n f l I k t
CONFLICT	k O n f l I k t
CONFORM	k @ n f o: m
CONFRONT	k @ n f r a n t
CONFUSE	k @ n f j u: z
CONGESTED	k @ n dZ E s t @ d
CONGRATULATE	k @ n g r A tS @ l EI t
CONGREGATE	k O N g r @ g EI t
CONGREGATION	k O N g r @ g EI S @ n
CONGRESS	k O N g r E s
CONJUNCTION	k @ n dZ a N k S @ n
CONJUNCTIVITIS	k @ n dZ a N k t @ v a: I t @ s
CONJUNCTIVITIS	k @ n dZ a N k t I v a: I t @ s
CONJURE	k a n dZ @
CONJURE	k O n dZ @
CONNECT	k @ n E k t
CONQUER	k O N k @
CONSCIENCE	k O n S @ n s
CONSCIENTIOUS	k O n S i: E n S @ s
CONSCIOUS	k O n S @ s
CONSCRIPT	k @ n s k r I p t
CONSCRIPT	k O n s k r I p t
CONSECUTIVE	k @ n s E k j @ t I v
CONSENT	k @ n s E n t
CONSEQUENCE	k O n s @ k w @ n s
CONSERVATION	k O n s @ v EI S @ n
CONSERVATIVE	k @ n s @: v @ t I v
CONSERVE	k @ n s @: v
CONSERVE	k O n s @: v
CONSIDER	k @ n s I d @
CONSIDERABLE	k @ n s I d r @ b @ l
CONSIDERABLE	k @ n s I d @ r @ b @ l
CONSIDERATE	k @ n s I d @ r @ t
CONSIDERATION	k @ n s I d @ r EI S @ n
CONSIST	k @ n s I s t
CONSISTENCY	k @ n s I s t @ n s i:
CONSISTENT	k @ n s I s t @ n t
CONSOLATION	k O n s @ l EI S @ n
CONSOLE	k @ n s @U l
CONSONANT	k O n s @ n @ n t
CONSPICUOUS	k @ n s p I k j u: @ s
CONSPIRACY	k @ n s p I r @ s i:
CONSTABLE	k a n s t @ b @ l
CONSTANT	k O n s t @ n t
CONSTELLATION	k O n s t @ l EI S @ n
CONSTERNATION	k O n s t @ n EI S @ n
CONSTIPATION	k O n s t @ p EI S @ n
CONSTITUENCY	k @ n s t I t j u: @ n s i:
CONSTITUTION	k O n s t @ t j u: S @ n
CONSTRICT	k @ n s t r I k t
CONSTRUCT	k @ n s t r a k t
CONSTRUCTIVE	k @ n s t r a k t I v
CONSUL	k O n s @ l
CONSULT	k @ n s a l t
CONSULTANT	k @ n s a l t @ n t
CONSUME	k @ n s j u: m
CONSUMER	k @ n s j u: m @
CONTACT	k O n t A k t
CONTAGIOUS	k @ n t EI dZ @ s
CONTAIN	k @ n t EI n
CONTAINER	k @ n t EI n @
CONTAMINATE	k @ n t A m @ n EI t
CONTEMPLATE	k O n t @ m p l EI t
CONTEMPORARY	k @ n t E m p @ r i:
CONTEMPT	k @ n t E m p t
CONTEND	k @ n t E n d
CONTENT	k O n t E n t
CONTENT	k @ n t E n t
CONTEST	k @ n t E s t
CONTEST	k O n t E s t
CONTEXT	k O n t E k s t
CONTINENT	k O n t @ n @ n t
CONTINUAL	k @ n t I n j u: @ l
CONTINUE	k @ n t I n j u:
CONTINUOUS	k @ n t I n j u: @ s
CONTOUR	k O n t U@
CONTOUR	k O n t u: @
CONTRABAND	k O n t r @ b A n d
CONTRACEPTION	k O n t r @ s E p S @ n
CONTRACEPTIVE	k O n t r @ s E p t I v
CONTRACT	k O n t r A k t
CONTRACT	k @ n t r A k t
CONTRADICT	k O n t r @ d I k t
CONTRARY	k O n t r @ r i:
CONTRAST	k O n t r a: s t
CONTRIBUTE	k @ n t r I b j u: t
CONTROL	k @ n t r @U l
CONTROVERSY	k O n t r @ v @: s i:
CONVALESCENCE	k O n v @ l E s @ n s
CONVENE	k @ n v i: n
CONVENIENCE	k @ n v i: n i: @ n s
CONVENIENT	k @ n v i: n i: @ n t
CONVENT	k O n v @ n t
CONVENTION	k @ n v E n S @ n
CONVENTIONAL	k @ n v E n S @ n @ l
CONVERSATION	k O n v @ s EI S @ n
CONVERSE	k O n v @: s
CONVERT	k @ n v @: t
CONVERTIBLE	k @ n v @: t @ b @ l
CONVEX	k O n v E k s
CONVEY	k @ n v EI
CONVICT	k @ n v I k t
CONVICTION	k @ n v I k S @ n
CONVINCE	k @ n v I n s
CONVOY	k O n v o: I
COOK	k U k
COOKBOOK	k U k b U k
COOL	k u: l
COOLABAH	k u: l @ b a:
COOP	k u: p
COOPERATE	k @U O p @ r EI t
COORDINATE	k @U o: d @ n EI t
COP	k O p
COPE	k @U p
COPPER	k O p @
COPY	k O p i:
COPYRIGHT	k O p i: r a: I t
CORAL	k O r @ l
CORD	k o: d
CORDIAL	k o: d i: @ l
CORDUROY	k o: dZ @ r o: I
CORDUROY	k o: d @ r o: I
CORE	k o:
CORK	k o: k
CORKSCREW	k o: k s k r u:
CORN	k o: n
CORNER	k o: n @
CORNFLAKES	k o: n f l EI k s
CORNY	k o: n i:
CORONARY	k O r @ n r i:
CORONATION	k O r @ n EI S @ n
CORONER	k O r @ n @
CORPORAL	k o: p @ r @ l
CORPORAL	k o: p r @ l
CORPORATION	k o: p @ r EI S @ n
CORPS	k o:
CORPSE	k o: p s
CORRECT	k @ r E k t
CORRESPOND	k O r @ s p O n d
CORRIDOR	k O r @ d o:
CORROBOREE	k @ r O b @ r i:
CORRODE	k @ r @U d
CORRUGATED	k O r @ g EI t @ d
CORRUPT	k @ r a p t
CORTISONE	k o: t @ z @U n
COSMETIC	k O z m E t I k
COSMOPOLITAN	k O z m @ p O l @ t @ n
COSMOS	k O z m O s
COSSIE	k O z i:
COST	k O s t
COSTUME	k O s t j u: m
COSY	k @U z i:
COT	k O t
COTTAGE	k O t I dZ
COTTON	k O t @ n
COUCH	k a: U tS
COUGH	k O f
COULD	k U d
COUNCIL	k a: U n s @ l
COUNSEL	k a: U n s @ l
COUNT	k a: U n t
COUNTER	k a: U n t @
COUNTERFEIT	k a: U n t @ f I t
COUNTERFEIT	k a: U n t @ f @ t
COUNTRY	k a n t r i:
COUP	k u:
COUPLE	k a p @ l
COUPON	k u: p O n
COURAGE	k a r I dZ
COURIER	k U r i: @
COURIER	k U@ r i: @
COURSE	k o: s
COURT	k o: t
COURTEOUS	k @: t i: @ s
COURTYARD	k o: t j a: d
COUSIN	k a z @ n
COVE	k @U v
COVENANT	k a v @ n @ n t
COVER	k a v @
COVET	k a v @ t
COW	k a: U
COWARD	k a: U@ d
CRAB	k r A b
CRACK	k r A k
CRACKER	k r A k @
CRACKLE	k r A k @ l
CRACKLING	k r A k l I N
CRADLE	k r EI d @ l
CRAFT	k r a: f t
CRAFTY	k r a: f t i:
CRAG	k r A g
CRAM	k r A m
CRAMP	k r A m p
CRAMPED	k r A m p t
CRANE	k r EI n
CRANK	k r A N k
CRANKY	k r A N k i:
CRASH	k r A S
CRATE	k r EI t
CRATER	k r EI t @
CRAVE	k r EI v
CRAWL	k r o: l
CRAYFISH	k r EI f I S
CRAYON	k r EI O n
CRAZE	k r EI z
CRAZY	k r EI z i:
CREAK	k r i: k
CREAM	k r i: m
CREASE	k r i: s
CREATE	k r i: EI t
CREATURE	k r i: tS @
CRECHE	k r EI S
CREDIBLE	k r E d @ b @ l
CREDIT	k r E d @ t
CREEK	k r i: k
CREEP	k r i: p
CREEPER	k r i: p @
CREMATE	k r @ m EI t
CREMATORIUM	k r E m @ t o: r i: @ m
CREPE	k r EI p
CREST	k r E s t
CREVICE	k r E v @ s
CREW	k r u:
CRIB	k r I b
CRICKET	k r I k @ t
CRIME	k r a: I m
CRIMSON	k r I m z @ n
CRINGE	k r I n dZ
CRINKLE	k r I N k @ l
CRIPPLE	k r I p @ l
CRISIS	k r a: I s @ s
CRISP	k r I s p
CRITIC	k r I t I k
CRITICAL	k r I t I k @ l
CROAK	k r @U k
CROATIAN	k r @U EI S @ n
CROCKERY	k r O k @ r i:
CROCODILE	k r O k @ d a: I l
CROOK	k r U k
CROOKED	k r U k @ d
CROON	k r u: n
CROP	k r O p
CROSS	k r O s
CROSS-EXAMINE	k r O s E g z A m @ n
CROSSROADS	k r O s r @U d z
CROSSWORD	k r O s w @: d
CROUCH	k r a: U tS
CROUPIER	k r u: p i: @
CROW	k r @U
CROWBAR	k r @U b a:
CROWD	k r a: U d
CROWN	k r a: U n
CRUCIAL	k r u: S @ l
CRUCIFY	k r u: s @ f a: I
CRUDE	k r u: d
CRUEL	k r u: @ l
CRUISE	k r u: z
CRUMB	k r a m
CRUMBLE	k r a m b @ l
CRUMMY	k r a m i:
CRUMPET	k r a m p @ t
CRUMPLE	k r a m p @ l
CRUNCH	k r a n tS
CRUSADE	k r u: s EI d
CRUSH	k r a S
CRUST	k r a s t
CRUSTACEAN	k r a s t EI S @ n
CRUTCH	k r a tS
CRUX	k r a k s
CRY	k r a: I
CRYPTIC	k r I p t I k
CRYSTAL	k r I s t @ l
CUB	k a b
CUBE	k j u: b
CUBIC	k j u: b I k
CUBICLE	k j u: b I k @ l
CUCUMBER	k j u: k a m b @
CUDDLE	k a d @ l
CUDDLY	k a d l i:
CUE	k j u:
CUFF	k a f
CUL-DE-SAC	k a l d @ s A k
CULINARY	k a l @ n r i:
CULMINATE	k a l m @ n EI t
CULPRIT	k a l p r @ t
CULT	k a l t
CULTIVATE	k a l t @ v EI t
CULTURE	k a l tS @
CUMBERSOME	k a m b @ s @ m
CUMQUAT	k a m k w O t
CUNNING	k a n I N
CUNT	k a n t
CUP	k a p
CUPBOARD	k a b @ d
CURB	k @: b
CURDLE	k @: d @ l
CURE	k j u: @
CURIOUS	k j u: r i: @ s
CURL	k @: l
CURRANT	k a r @ n t
CURRAWONG	k a r @ w O N
CURRENCY	k a r @ n s i:
CURRENT	k a r @ n t
CURRICULUM	k @ r I k j @ l @ m
CURRICULUMVITAE	k @ r I k j @ l @ m v i: t a: I
CURRY	k a r i:
CURSE	k @: s
CURT	k @: t
CURTAIL	k @: t EI l
CURTAIN	k @: t @ n
CURTSY	k @: t s i:
CURVE	k @: v
CUSHION	k U S @ n
CUSHY	k U S i:
CUSTARD	k a s t @ d
CUSTODY	k a s t @ d i:
CUSTOM	k a s t @ m
CUSTOMARY	k a s t @ m @ r i:
CUSTOMARY	k a s t @ m r i:
CUSTOMER	k a s t @ m @
CUT	k a t
CUTE	k j u: t
CUTICLE	k j u: t I k @ l
CUTLERY	k a t l @ r i:
CUTLET	k a t l @ t
CV	s i: v i:
CYCLE	s a: I k @ l
CYCLONE	s a: I k l @U n
CYLINDER	s I l @ n d @
CYNIC	s I n I k
CYNICAL	s I n I k @ l
CYST	s I s t
CYSTITIS	s I s t a: I t @ s
CZECH	tS E k
D	d i:
DAB	d A b
DAD	d A d
DAGGER	d A g @
DAILY	d EI l i:
DAINTY	d EI n t i:
DAIRY	d E@ r i:
DAIS	d EI @ s
DAM	d A m
DAMAGE	d A m I dZ
DAMN	d A m
DAMNED	d A m d
DAMNEDEST	d A m d @ s t
DAMP	d A m p
DAMPEN	d A m p @ n
DAMPER	d A m p @
DANCE	d A n s
DANDRUFF	d A n d r a f
DANGER	d EI n dZ @
DANGLE	d A N g @ l
DANK	d A N k
DAPPER	d A p @
DAPPLED	d A p @ l d
DARE	d E@
DAREDEVIL	d E@ d E v @ l
DARK	d a: k
DARKROOM	d a: k r u: m
DARLING	d a: l I N
DARN	d a: n
DART	d a: t
DASH	d A S
DASHBOARD	d A S b o: d
DATA	d a: t @
DATABASE	d EI t @ b EI s
DATE	d EI t
DATED	d EI t @ d
DAUB	d o: b
DAUGHTER	d o: t @
DAUGHTER-IN-LAW	d o: t @ r I n l o:
DAUNT	d o: n t
DAWDLE	d o: d @ l
DAWN	d o: n
DAY	d EI
DAYCARECENTRE	d EI k E@ s E n t @
DAYBREAK	d EI b r EI k
DAYDREAM	d EI d r i: m
DAYLIGHT	d EI l a: I t
DAYTIME	d EI t a: I m
DAZE	d EI z
DAZZLE	d A z @ l
DEFACTO	d @ f A k t @U
DEAD	d E d
DEADEND	d E d E n d
DEADHEAT	d E d h i: t
DEADLETTER	d E d l E t @
DEAD-END	d E d E n d
DEADEN	d E d @ n
DEADLINE	d E d l a: I n
DEADLOCK	d E d l O k
DEADLY	d E d l i:
DEAF	d E f
DEAL	d i: l
DEALER	d i: l @
DEALINGS	d i: l I N z
DEAR	d I@
DEATH	d E T
DEBATABLE	d @ b EI t @ b @ l
DEBATE	d @ b EI t
DEBIT	d E b @ t
DEBRIS	d E b r i:
DEBT	d E t
DEBUG	d i: b a g
DEBUT	d EI b j u:
DECADE	d E k EI d
DECADENT	d E k @ d @ n t
DECAFFEINATED	d i: k A f @ n EI t @ d
DECAPITATE	d i: k A p @ t EI t
DECATHLON	d @ k A T l O n
DECAY	d i: k EI
DECAY	d @ k EI
DECEASED	d @ s i: s t
DECEITFUL	d @ s i: t f U l
DECEIVE	d @ s i: v
DECEMBER	d @ s E m b @
DECENT	d i: s @ n t
DECENTRALISE	d i: s E n t r @ l a: I z
DECEPTION	d @ s E p S @ n
DECEPTIVE	d @ s E p t I v
DECIBEL	d E s @ b E l
DECIDE	d @ s a: I d
DECIDED	d @ s a: I d @ d
DECIDUOUS	d @ s I dZ u: @ s
DECIMAL	d E s @ m @ l
DECIMATE	d E s @ m EI t
DECIPHER	d @ s a: I f @
DECISION	d @ s I Z @ n
DECK	d E k
DECLARE	d @ k l E@
DECLINE	d @ k l a: I n
DECODE	d i: k @U d
DECOMPOSE	d i: k @ m p @U z
DECONGESTANT	d i: k @ n dZ E s t @ n t
DECOR	d EI k o:
DECORATE	d E k @ r EI t
DECORATION	d E k @ r EI S @ n
DECORUM	d @ k o: r @ m
DECOY	d i: k o: I
DECREASE	d i: k r i: s
DECREASE	d @ k r i: s
DECREE	d @ k r i:
DECREPIT	d @ k r E p @ t
DECRY	d @ k r a: I
DEDICATE	d E d @ k EI t
DEDUCE	d @ d j u: s
DEDUCT	d @ d a k t
DEDUCTION	d @ d a k S @ n
DEED	d i: d
DEEP	d i: p
DEEPFREEZE	d i: p f r i: z
DEER	d I@
DEFACE	d @ f EI s
DEFAMATION	d E f @ m EI S @ n
DEFAULT	d @ f O l t
DEFEAT	d @ f i: t
DEFECATE	d E f @ k EI t
DEFECT	d i: f E k t
DEFENCE	d @ f E n s
DEFEND	d @ f E n d
DEFENDANT	d @ f E n d @ n t
DEFENSIVE	d @ f E n s I v
DEFER	d @ f @:
DEFIANT	d @ f a: I@ n t
DEFICIENT	d @ f I S @ n t
DEFICIT	d E f @ s @ t
DEFINE	d @ f a: I n
DEFINITE	d E f @ n @ t
DEFINITIVE	d @ f I n @ t I v
DEFLATE	d @ f l EI t
DEFLATION	d @ f l EI S @ n
DEFLECT	d @ f l E k t
DEFOLIANT	d @ f @U l i: @ n t
DEFOLIATE	d @ f @U l i: EI t
DEFORM	d @ f o: m
DEFRAUD	d @ f r o: d
DEFROST	d i: f r O s t
DEFT	d E f t
DEFUNCT	d @ f a N k t
DEFUSE	d i: f j u: z
DEFUSE	d @ f j u: z
DEFY	d @ f a: I
DEGENERATE	d @ dZ E n @ r @ t
DEGRADATION	d E g r @ d EI S @ n
DEGRADE	d @ g r EI d
DEGREE	d @ g r i:
DEHYDRATE	d i: h a: I d r EI t
DEIGN	d EI n
DEITY	d EI @ t i:
DEJECTED	d @ dZ E k t @ d
DELAY	d @ l EI
DELECTABLE	d @ l E k t @ b @ l
DELEGATE	d E l @ g @ t
DELEGATION	d E l @ g EI S @ n
DELETE	d @ l i: t
DELI	d E l i:
DELIBERATE	d @ l I b @ r @ t
DELIBERATE	d @ l I b r @ t
DELICACY	d E l @ k @ s i:
DELICATE	d E l @ k @ t
DELICATESSEN	d E l @ k @ t E s @ n
DELICIOUS	d @ l I S @ s
DELIGHT	d @ l a: I t
DELINQUENT	d @ l I N k w @ n t
DELIRIOUS	d @ l I@ r i: @ s
DELIVER	d @ l I v @
DELTA	d E l t @
DELUDE	d @ l u: d
DELUGE	d E l j u: dZ
DELUXE	d @ l a k s
DELVE	d E l v
DEMAND	d @ m A n d
DEMANDING	d @ m A n d I N
DEMEAN	d @ m i: n
DEMEANOUR	d @ m i: n @
DEMENTED	d @ m E n t @ d
DEMENTIA	d @ m E n S @
DEMERIT	d i: m E r @ t
DEMISE	d @ m a: I z
DEMISTER	d i: m I s t @
DEMO	d E m @U
DEMOCRACY	d @ m O k r @ s i:
DEMOCRAT	d E m @ k r A t
DEMOCRATS	d E m @ k r A t s
DEMOLISH	d @ m O l I S
DEMON	d i: m @ n
DEMONSTRATE	d E m @ n s t r EI t
DEMONSTRATION	d E m @ n s t r EI S @ n
DEMONSTRATIVE	d @ m O n s t r @ t I v
DEMORALISE	d @ m O r @ l a: I z
DEMOTE	d i: m @U t
DEMURE	d @ m j U@
DEN	d E n
DENIGRATE	d E n @ g r EI t
DENIM	d E n @ m
DENOMINATION	d @ n O m @ n EI S @ n
DENOMINATOR	d @ n O m @ n EI t @
DENOUNCE	d @ n a: U n s
DENSE	d E n s
DENT	d E n t
DENTAL	d E n t @ l
DENTALFLOSS	d E n t @ l f l O s
DENTIST	d E n t @ s t
DENTURE	d E n tS @
DENY	d @ n a: I
DEODORANT	d i: @U d @ r @ n t
DEPART	d @ p a: t
DEPARTED	d @ p a: t @ d
DEPARTMENT	d @ p a: t m @ n t
DEPEND	d @ p E n d
DEPENDANT	d @ p E n d @ n t
DEPENDENT	d @ p E n d @ n t
DEPICT	d @ p I k t
DEPLETE	d @ p l i: t
DEPLORE	d @ p l o:
DEPORT	d @ p o: t
DEPORTMENT	d @ p o: t m @ n t
DEPOSE	d @ p @U z
DEPOSIT	d @ p O z @ t
DEPOSITORY	d @ p O z @ t r i:
DEPOT	d E p @U
DEPRAVED	d @ p r EI v d
DEPRECIATE	d @ p r i: S i: EI t
DEPRESS	d @ p r E s
DEPRESSION	d @ p r E S @ n
DEPRIVE	d @ p r a: I v
DEPRIVED	d @ p r a: I v d
DEPT	d @ p a: t m @ n t
DEPTH	d E p T
DEPUTATION	d E p j @ t EI S @ n
DEPUTATION	d E p j u: t EI S @ n
DEPUTY	d E p j @ t i:
DERANGED	d @ r EI n dZ d
DERELICT	d E r @ l I k t
DERIDE	d @ r a: I d
DERIVATIVE	d @ r I v @ t I v
DERIVE	d @ r a: I v
DERMATITIS	d @: m @ t a: I t @ s
DEROGATORY	d @ r O g @ t r i:
DESCEND	d @ s E n d
DESCENDANT	d @ s E n d @ n t
DESCENDED	d @ s E n d @ d
DESCENT	d @ s E n t
DESCRIBE	d @ s k r a: I b
DESCRIPTION	d @ s k r I p S @ n
DESECRATE	d E s @ k r EI t
DESERT	d E z @ t
DESERVE	d @ z @: v
DESIGN	d @ z a: I n
DESIGNATE	d E z I g n EI t
DESIRABLE	d @ z a: I r @ b @ l
DESIRE	d @ z a: I@
DESK	d E s k
DESKTOP	d E s k t O p
DESOLATE	d E s @ l @ t
DESPAIR	d @ s p E@
DESPERATE	d E s p r @ t
DESPICABLE	d @ s p I k @ b @ l
DESPISE	d @ s p a: I z
DESPITE	d @ s p a: I t
DESPONDENT	d @ s p O n d @ n t
DESPOT	d E s p O t
DESSERT	d @ z @: t
DESTINATION	d E s t @ n EI S @ n
DESTINED	d E s t @ n d
DESTINY	d E s t @ n i:
DESTITUTE	d E s t @ t j u: t
DESTROY	d @ s t r o: I
DETACH	d @ t A tS
DETACHED	d @ t A tS t
DETACHMENT	d @ t A tS m @ n t
DETAIL	d i: t EI l
DETAIN	d @ t EI n
DETECT	d @ t E k t
DETECTIVE	d @ t E k t I v
DETENTION	d @ t E n S @ n
DETER	d @ t @:
DETERGENT	d @ t @: dZ @ n t
DETERIORATE	d @ t I@ r i: @ r EI t
DETERMINATION	d @ t @: m @ n EI S @ n
DETERMINE	d @ t @: m @ n
DETERMINED	d @ t @: m @ n d
DETERMINER	d @ t @: m @ n @
DETERRENT	d @ t E r @ n t
DETEST	d @ t E s t
DETONATE	d E t @ n EI t
DETOUR	d i: t U@
DETRACT	d @ t r A k t
DETRIMENTAL	d E t r @ m E n t @ l
DEVALUE	d i: v A l j u:
DEVASTATE	d E v @ s t EI t
DEVASTATING	d E v @ s t EI t I N
DEVELOP	d @ v E l @ p
DEVELOPER	d @ v E l @ p @
DEVELOPMENT	d @ v E l @ p m @ n t
DEVIANT	d i: v i: @ n t
DEVIATE	d i: v i: EI t
DEVICE	d @ v a: I s
DEVIL	d E v @ l
DEVIOUS	d i: v i: @ s
DEVISE	d @ v a: I z
DEVOID	d @ v o: I d
DEVOTE	d @ v @U t
DEVOTED	d @ v @U t @ d
DEVOTEE	d E v @ t i:
DEVOUR	d @ v a: U@
DEVOUT	d @ v a: U t
DEW	d j u:
DEW	dZ u:
DEXTERITY	d E k s t E r @ t i:
DIABETES	d a: I@ b i: t i: z
DIABOLIC	d a: I@ b O l I k
DIAGNOSE	d a: I@ g n @U z
DIAGONAL	d a: I A g @ n @ l
DIAGRAM	d a: I@ g r A m
DIAL	d a: I@ l
DIALECT	d a: I@ l E k t
DIALOGUE	d a: I@ l O g
DIAMETER	d a: I A m @ t @
DIAMETRICALLY	d a: I@ m E t r I k l i:
DIAMOND	d a: I@ m @ n d
DIAPHRAGM	d a: I@ f r A m
DIARRHOEA	d a: I@ r i: @
DIARY	d a: I@ r i:
DICE	d a: I s
DICEY	d a: I s i:
DICK	d I k
DICKHEAD	d I k h E d
DICTATE	d I k t EI t
DICTATOR	d I k t EI t @
DICTION	d I k S @ n
DICTIONARY	d I k S @ n r i:
DID	d I d
DIDGERIDOO	d I dZ @ r i: d u:
DIE	d a: I
DIESEL	d i: z @ l
DIET	d a: I@ t
DIFFER	d I f @
DIFFERENCE	d I f r @ n s
DIFFERENT	d I f r @ n t
DIFFERENTIATE	d I f @ r E n S i: EI t
DIFFICULT	d I f @ k @ l t
DIFFIDENT	d I f @ d @ n t
DIFFUSE	d @ f j u: z
DIG	d I g
DIGEST	d @ dZ E s t
DIGEST	d a: I dZ E s t
DIGGER	d I g @
DIGGINGS	d I g I N z
DIGIT	d I dZ @ t
DIGITAL	d I dZ @ t @ l
DIGNITARY	d I g n @ t r i:
DIGNITY	d I g n @ t i:
DIGRESS	d a: I g r E s
DILAPIDATED	d @ l A p @ d EI t @ d
DILATE	d a: I l EI t
DILEMMA	d @ l E m @
DILIGENT	d I l @ dZ @ n t
DILL	d I l
DILUTE	d a: I l u: t
DIM	d I m
DIMENSION	d @ m E n S @ n
DIMINISH	d @ m I n I S
DIMPLE	d I m p @ l
DIN	d I n
DINE	d a: I n
DINER	d a: I n @
DING	d I N
DINGHY	d I N g i:
DINGO	d I N g @U
DINGY	d I n dZ i:
DINING	d a: I n I N
DININGCAR	d a: I n I N k a:
DININGROOM	d a: I n I N r u: m
DININGTABLE	d a: I n I N t EI b @ l
DINKI-DI	d I N k i: d a: I
DINKUM	d I N k @ m
DINNER	d I n @
DINOSAUR	d a: I n @ s o:
DIP	d I p
DIPHTHERIA	d I f T I@ r i: @
DIPHTHONG	d I f T O N
DIPLOMA	d @ p l @U m @
DIPLOMACY	d @ p l @U m @ s i:
DIPLOMAT	d I p l @ m A t
DIRE	d a: I@
DIRECT	d @ r E k t
DIRECTION	d @ r E k S @ n
DIRECTIVE	d @ r E k t I v
DIRECTLY	d @ r E k t l i:
DIRECTOR	d @ r E k t @
DIRECTORY	d @ r E k t r i:
DIRT	d @: t
DIRTY	d @: t i:
DISABILITY	d I s @ b I l @ t i:
DISABLE	d I s EI b @ l
DISADVANTAGE	d I s @ d v A n t I dZ
DISADVANTAGED	d I s @ d v A n t I dZ d
DISAGREE	d I s @ g r i:
DISAGREEABLE	d I s @ g r i: @ b @ l
DISALLOW	d I s @ l a: U
DISAPPEAR	d I s @ p I@
DISAPPOINT	d I s @ p o: I n t
DISAPPROVE	d I s @ p r u: v
DISARM	d I s a: m
DISARRAY	d I s @ r EI
DISASTER	d @ z a: s t @
DISBAND	d I s b A n d
DISBELIEVE	d I s b @ l i: v
DISC	d I s k
DISCJOCKEY	d I s k dZ O k i:
DISCARD	d I s k a: d
DISCERN	d I s @: n
DISCERN	d @ s @: n
DISCERNING	d I s @: n I N
DISCERNING	d @ s @: n I N
DISCHARGE	d I s tS a: dZ
DISCIPLE	d @ s a: I p @ l
DISCIPLINARIAN	d I s @ p l @ n E@ r i: @ n
DISCIPLINE	d I s @ p l @ n
DISCLOSE	d @ s k l @U z
DISCLOSE	d I s k l @U z
DISCO	d I s k @U
DISCOLOUR	d I s k a l @
DISCOMFORT	d I s k a m f @ t
DISCONCERT	d I s k @ n s @: t
DISCONNECT	d I s k @ n E k t
DISCONTENT	d I s k @ n t E n t
DISCONTINUE	d I s k @ n t I n j u:
DISCORD	d I s k o: d
DISCOUNT	d I s k a: U n t
DISCOURAGE	d I s k a r I dZ
DISCOURSE	d I s k o: s
DISCOURTEOUS	d I s k @: t i: @ s
DISCOVER	d @ s k a v @
DISCOVER	d I s k a v @
DISCREDIT	d I s k r E d @ t
DISCREET	d I s k r i: t
DISCREET	d @ s k r i: t
DISCREPANCY	d I s k r E p @ n s i:
DISCREPANCY	d @ s k r E p @ n s i:
DISCRETE	d I s k r i: t
DISCRETE	d @ s k r i: t
DISCRETION	d I s k r E S @ n
DISCRETION	d @ s k r E S @ n
DISCRIMINATE	d I s k r I m @ n EI t
DISCRIMINATE	d @ s k r I m @ n EI t
DISCUSS	d @ s k a s
DISDAIN	d I s d EI n
DISEASE	d @ z i: z
DISFAVOUR	d I s f EI v @
DISFIGURE	d I s f I g @
DISGRACE	d @ s g r EI s
DISGRUNTLED	d I s g r a n t @ l d
DISGUISE	d I s g a: I z
DISGUISE	d @ s g a: I z
DISGUST	d @ s g a s t
DISH	d I S
DISHEARTENED	d I s h a: t @ n d
DISHEVELLED	d I S E v @ l d
DISHONEST	d I s O n @ s t
DISHONOUR	d I s O n @
DISHWASHER	d I S w O S @
DISILLUSIONED	d I s @ l u: Z @ n d
DISINCLINED	d I s I n k l a: I n d
DISINCLINED	d I s I N k l a: I n d
DISINFECT	d I s I n f E k t
DISINFECTANT	d I s I n f E k t @ n t
DISINTEGRATE	d I s I n t @ g r EI t
DISINTERESTED	d I s I n t r @ s t @ d
DISJOINTED	d I s dZ o: I n t @ d
DISK	d I s k
DISKETTE	d I s k E t
DISLIKE	d I s l a: I k
DISLOCATE	d I s l @ k EI t
DISLODGE	d I s l O dZ
DISLOYAL	d I s l o: I@ l
DISMAL	d I z m @ l
DISMANTLE	d I s m A n t @ l
DISMAY	d I s m EI
DISMISS	d I s m I s
DISMOUNT	d I s m a: U n t
DISOBEY	d I s @ b EI
DISORDER	d I s o: d @
DISORGANISED	d I s o: g @ n a: I z d
DISORIENTATED	d I s O r i: @ n t EI t @ d
DISPATCH	d I s p A tS
DISPEL	d I s p E l
DISPENSABLE	d I s p E n s @ b @ l
DISPENSATION	d I s p E n s EI S @ n
DISPENSE	d I s p E n s
DISPERSE	d I s p @: s
DISPLACE	d I s p l EI s
DISPLAY	d I s p l EI
DISPLEASE	d I s p l i: z
DISPOSABLE	d I s p @U z @ b @ l
DISPOSABLEINCOME	d I s p @U z @ b @ l I N k a m
DISPOSAL	d I s p @U z @ l
DISPOSE	d I s p @U z
DISPOSED	d I s p @U z d
DISPOSITION	d I s p @ z I S @ n
DISPOSSESS	d I s p @ z E s
DISPROPORTION	d I s p r @ p o: S @ n
DISPROVE	d I s p r u: v
DISPUTE	d I s p j u: t
DISQUALIFY	d I s k w O l @ f a: I
DISREGARD	d I s r @ g a: d
DISREPAIR	d I s r @ p E@
DISREPUTABLE	d I s r E p j @ t @ b @ l
DISREPUTE	d I s r @ p j u: t
DISRESPECT	d I s r @ s p E k t
DISRUPT	d I s r a p t
DISSATISFIED	d I s A t I s f a: I d
DISSECT	d a: I s E k t
DISSECT	d @ s E k t
DISSENSION	d @ s E n S @ n
DISSENSION	d I s E n S @ n
DISSENT	d @ s E n t
DISSENT	d I s E n t
DISSERTATION	d I s @ t EI S @ n
DISSIDENT	d I s @ d @ n t
DISSIMILAR	d I s s I m @ l @
DISSIPATE	d I s @ p EI t
DISSOCIATE	d I s s @U s i: EI t
DISSOLUTION	d I s @ l u: S @ n
DISSOLVE	d @ z O l v
DISSUADE	d I s s w EI d
DISTANCE	d I s t @ n s
DISTANT	d I s t @ n t
DISTASTEFUL	d I s t EI s t f @ l
DISTASTEFUL	d I s t EI s t f U l
DISTEND	d I s t E n d
DISTIL	d I s t I l
DISTILLATE	d I s t @ l @ t
DISTINCT	d @ s t I N k t
DISTINCTION	d @ s t I N k S @ n
DISTINCTIVE	d @ s t I N k t I v
DISTINGUISH	d @ s t I N g w I S
DISTORT	d @ s t o: t
DISTRACT	d @ s t r A k t
DISTRAUGHT	d I s t r o: t
DISTRAUGHT	d @ s t r o: t
DISTRESS	d @ s t r E s
DISTRIBUTE	d @ s t r I b j u: t
DISTRIBUTION	d I s t r @ b j u: S @ n
DISTRICT	d I s t r I k t
DISTRUST	d I s t r a s t
DISTURB	d @ s t @: b
DISTURBANCE	d @ s t @: b @ n s
DISTURBED	d @ s t @: b d
DISUSE	d I s j u: s
DITCH	d I tS
DITHER	d I D @
DITTO	d I t @U
DIVAN	d @ v A n
DIVE	d a: I v
DIVER	d a: I v @
DIVERGE	d a: I v @: dZ
DIVERSE	d a: I v @: s
DIVERSIFY	d @ v @: s @ f a: I
DIVERSION	d @ v @: Z @ n
DIVIDE	d @ v a: I d
DIVIDEND	d I v @ d E n d
DIVINATION	d I v @ n EI S @ n
DIVINE	d @ v a: I n
DIVINITY	d @ v I n @ t i:
DIVISION	d @ v I Z @ n
DIVORCE	d @ v o: s
DIVORCEE	d @ v o: s i:
DIVULGE	d @ v a l dZ
DIZZY	d I z i:
DO	d u:
DOB	d O b
DOCILE	d @U s a: I l
DOCK	d O k
DOCKET	d O k @ t
DOCKYARD	d O k j a: d
DOCTOR	d O k t @
DOCTORS	d O k t @ z
DOCTRINE	d O k t r @ n
DOCUMENT	d O k j @ m @ n t
DOCUMENTARY	d O k j @ m E n t r i:
DODGE	d O dZ
DODGY	d O dZ i:
DOE	d @U
DOES	d a z
DOG	d O g
DOG-EAR	d O g I@
DOGGED	d O g @ d
DOGLEG	d O g l E g
DOGMA	d O g m @
DOGMATIC	d O g m A t I k
DOILY	d o: I l i:
DOING	d u: I N
DOLDRUMS	d O l d r @ m z
DOLE	d @U l
DOLEFUL	d @U l f U l
DOLL	d O l
DOLLAR	d O l @
DOLLOP	d O l @ p
DOLLS	d O l z
DOMAIN	d @ m EI n
DOME	d @U m
DOMESTIC	d @ m E s t I k
DOMESTICATE	d @ m E s t @ k EI t
DOMINATE	d O m @ n EI t
DOMINEERING	d O m @ n I@ r I N
DONATE	d @U n EI t
DONE	d a n
DONKEY	d O N k i:
DONOR	d @U n @
DONT	d @U n t
DOODLE	d u: d @ l
DOOM	d u: m
DOOMSDAY	d u: m z d EI
DOONA	d u: n @
DOOR	d o:
DOPE	d @U p
DOPEY	d @U p i:
DORK	d o: k
DORM	d o: m
DORMANT	d o: m @ n t
DORMITORY	d o: m @ t r i:
DOSE	d @U s
DOSSIER	d O s i: @
DOT	d O t
DOTE	d @U t
DOTTY	d O t i:
DOUBLE	d a b @ l
DOUBLEBASS	d a b @ l b EI s
DOUBLECROSS	d a b @ l k r O s
DOUBT	d a: U t
DOUBTFUL	d a: U t f U l
DOUGH	d @U
DOUR	d U@
DOUSE	d a: U s
DOVE	d a v
DOWDY	d a: U d i:
DOWN	d a: U n
DOWNPAYMENT	d a: U n p EI m @ n t
DOWN-MARKET	d a: U n m a: k @ t
DOWN-TO-EARTH	d a: U n t u: @: T
DOWNCAST	d a: U n k a: s t
DOWNFALL	d a: U n f o: l
DOWNGRADE	d a: U n g r EI d
DOWNHEARTED	d a: U n h a: t @ d
DOWNHILL	d a: U n h I l
DOWNPLAY	d a: U n p l EI
DOWNPOUR	d a: U n p o:
DOWNSTREAM	d a: U n s t r i: m
DOWNTOWN	d a: U n t a: U n
DOWNTRODDEN	d a: U n t r O d @ n
DOWNTURN	d a: U n t @: n
DOWNWARD	d a: U n w @ d
DOWNWARDS	d a: U n w @ d z
DOWNWIND	d a: U n w I n d
DOWNY	d a: U n i:
DOWRY	d a: U r i:
DOZ	d a z @ n
DOZE	d @U z
DOZEN	d a z @ n
DR	d O k t @
DRAB	d r A b
DRAFT	d r a: f t
DRAG	d r A g
DRAGON	d r A g @ n
DRAGONFLY	d r A g @ n f l a: I
DRAIN	d r EI n
DRAKE	d r EI k
DRAMA	d r a: m @
DRAMATIC	d r @ m A t I k
DRAMATISE	d r A m @ t a: I z
DRANK	d r A N k
DRAPE	d r EI p
DRASTIC	d r A s t I k
DRAUGHT	d r a: f t
DRAW	d r o:
DRAWBACK	d r o: b A k
DRAWCARD	d r o: k a: d
DRAWER	d r o:
DRAWING-PIN	d r o: I N p I n
DRAWL	d r o: l
DRAWN	d r o: n
DREAD	d r E d
DREADFUL	d r E d f U l
DREAM	d r i: m
DREAMING	d r i: m I N
DREAMT	d r E m t
DREARY	d r I@ r i:
DRENCH	d r E n tS
DRESS	d r E s
DRESSER	d r E s @
DRESSING	d r E s I N
DRESSING-GOWN	d r E s I N g a: U n
DRESSING-TABLE	d r E s I N t EI b @ l
DRESSMAKER	d r E s m EI k @
DREW	d r u:
DRIBBLE	d r I b @ l
DRIED	d r a: I d
DRIER	d r a: I@
DRIFT	d r I f t
DRILL	d r I l
DRINK	d r I N k
DRINK-DRIVING	d r I N k d r a: I v I N
DRIP	d r I p
DRIP-DRY	d r I p d r a: I
DRIPPING	d r I p I N
DRIVE	d r a: I v
DRIVE-IN	d r a: I v I n
DRIVERSLICENCE	d r a: I v @ z l a: I s @ n s
DRIVEWAY	d r a: I v w EI
DRIVINGTEST	d r a: I v I N t E s t
DRIZZLE	d r I z @ l
DRONE	d r @U n
DRONGO	d r O N g @U
DROOP	d r u: p
DROP	d r O p
DROP-OUT	d r O p a: U t
DROPLET	d r O p l @ t
DROPPER	d r O p @
DROPPINGS	d r O p I N z
DROUGHT	d r a: U t
DROVE	d r @U v
DROWN	d r a: U n
DROWSY	d r a: U z i:
DRUG	d r a g
DRUM	d r a m
DRUMSTICK	d r a m s t I k
DRUNK	d r a N k
DRY	d r a: I
DRY-CLEAN	d r a: I k l i: n
DUAL	d j u: @ l
DUB	d a b
DUBIOUS	d j u: b i: @ s
DUCK	d a k
DUE	d j u:
DUE	dZ u:
DUEL	d j u: @ l
DUET	d j u: E t
DUG	d a g
DUGOUT	d a g a: U t
DULL	d a l
DULY	d j u: l i:
DUMB	d a m
DUMMY	d a m i:
DUMP	d a m p
DUMPLING	d a m p l I N
DUMPY	d a m p i:
DUNE	dZ u: n
DUNE	d j u: n
DUNG	d a N
DUNK	d a N k
DUNNY	d a n i:
DUO	d j u: @U
DUODENUM	d j u: @ d i: n @ m
DUPE	d j u: p
DUPLEX	d j u: p l E k s
DUPLICATE	d j u: p l @ k EI t
DURABLE	d j u: r @ b @ l
DURATION	d j u: r EI S @ n
DURING	d j u: r I N
DUSK	d a s k
DUST	d a s t
DUSTPAN	d a s t p A n
DUTCH	d a tS
DUTY	d j u: t i:
DUTY-FREE	d j u: t i: f r i:
DUVET	d u: v EI
DWARF	d w o: f
DWELL	d w E l
DWINDLE	d w I n d @ l
DYE	d a: I
DYING	d a: I I N
DYNAMIC	d a: I n A m I k
DYNAMICS	d a: I n A m I k s
DYNAMITE	d a: I n @ m a: I t
DYSENTERY	d I s @ n t r i:
DYSLEXIA	d I s l E k s i: @
E	i:
E-MAIL	i: m EI l
EG	i: dZ i:
EACH	i: tS
EAGER	i: g @
EAR	I@
EARDRUM	I@ d r a m
EARLY	@: l i:
EARN	@: n
EARNEST	@: n @ s t
EARPHONE	I@ f @U n
EARRING	I@ r I N
EARTH	@: T
EARTHENWARE	@: D @ n w E@
EARTHQUAKE	@: T k w EI k
EASE	i: z
EASEL	i: z @ l
EAST	i: s t
EASTER	i: s t @
EASTWARD	i: s t w @ d
EASY	i: z i:
EAT	i: t
EAVES	i: v z
EAVESDROP	i: v z d r O p
EB	i: b i:
EBB	E b
ECCENTRIC	E k s E n t r I k
ECCENTRIC	@ k s E n t r I k
ECG	i: s i: dZ i:
ECHIDNA	@ k I d n @
ECHO	E k @U
ECLIPSE	@ k l I p s
ECOLOGY	@ k O l @ dZ i:
ECONOMICS	E k @ n O m I k s
ECONOMY	@ k O n @ m i:
ECZEMA	E k s @ m @
EDGE	E dZ
EDIBLE	E d @ b @ l
EDIT	E d @ t
EDITION	@ d I S @ n
EDITORIAL	E d @ t o: r i: @ l
EDUCATION	E dZ @ k EI S @ n
EERIE	I@ r i:
EFFECT	@ f E k t
EFFECTIVE	@ f E k t I v
EFFEMINATE	@ f E m @ n @ t
EFFERVESCENT	E f @ v E s @ n t
EFFICIENT	@ f I S @ n t
EFFORT	E f @ t
EFTPOS	E f t p O s
EGG	E g
EGO	i: g @U
EIDERDOWN	a: I d @ d a: U n
EIGHT	EI t
EIGHTEEN	EI t i: n
EIGHTEENTH	EI t i: n T
EIGHTH	EI t T
EIGHTY	EI t i:
EITHER	a: I D @
EJECT	@ dZ E k t
ELABORATE	@ l A b @ r @ t
ELAPSE	@ l A p s
ELASTIC	@ l A s t I k
ELATED	@ l EI t @ d
ELBOW	E l b @U
ELDER	E l d @
ELDERLY	E l d @ l i:
ELDEST	E l d @ s t
ELECT	@ l E k t
ELECTION	@ l E k S @ n
ELECTIVE	@ l E k t I v
ELECTORATE	@ l E k t @ r @ t
ELECTRICIAN	@ l E k t r I S @ n
ELECTRICITY	@ l E k t r I s @ t i:
ELECTROCUTE	@ l E k t r @ k j u: t
ELECTRONIC	E l @ k t r O n I k
ELEGANT	E l @ g @ n t
ELEMENT	E l @ m @ n t
ELEMENTARY	E l @ m E n t r i:
ELEVATE	E l @ v EI t
ELEVATOR	E l @ v EI t @
ELEVEN	@ l E v @ n
ELEVENTH	@ l E v @ n T
ELIGIBLE	E l @ dZ @ b @ l
ELIMINATE	@ l I m @ n EI t
ELITE	@ l i: t
ELLIPSE	@ l I p s
ELOQUENT	E l @ k w @ n t
ELSE	E l s
ELSEWHERE	E l s w E@
ELUSIVE	@ l u: s I v
EMBARGO	@ m b a: g @U
EMBARK	@ m b a: k
EMBARRASS	@ m b A r @ s
EMBASSY	E m b @ s i:
EMBEZZLE	@ m b E z @ l
EMBLEM	E m b l @ m
EMBRACE	@ m b r EI s
EMBROIDER	@ m b r o: U d @
EMBROIDER	E m b r o: I d @
EMBRYO	E m b r i: @U
EMERALD	E m r @ l d
EMERGE	@ m @: dZ
EMERGENCY	@ m @: dZ @ n s i:
EMIGRANT	E m @ g r @ n t
EMIGRATE	E m @ g r EI t
EMINENT	E m @ n @ n t
EMOTION	@ m @U S @ n
EMPHASIS	E m f @ s @ s
EMPIRE	E m p a: I@
EMPLOY	@ m p l o: I
EMPTY	E m t i:
EMU	i: m j u:
ENABLE	@ n EI b @ l
ENAMEL	@ n A m @ l
ENCLOSE	@ n k l @U z
ENCODE	@ n k @U d
ENCORE	O n k o:
ENCOUNTER	@ n k a: U n t @
ENCOURAGE	@ n k a r I dZ
ENCYCLOPEDIA	E n s a: I k l @ p i: d i: @
END	E n d
ENDANGER	@ n d EI n dZ @
ENDEAVOUR	@ n d E v @
ENDORSE	@ n d o: s
ENDURE	@ n d j u: @
ENEMY	E n @ m i:
ENERGY	E n @ dZ i:
ENGAGE	@ n g EI dZ
ENGAGEMENT	@ n g EI dZ m @ n t
ENGINE	E n dZ @ n
ENGINEER	E n dZ @ n I@
ENGLISH	I N g l I S
ENGRAVE	@ n g r EI v
ENJOY	@ n dZ o: I
ENLARGE	@ n l a: dZ
ENLIST	@ n l I s t
ENORMOUS	@ n o: m @ s
ENOUGH	@ n a f
ENQUIRY	I n k w a: I r i:
ENRAGE	@ n r EI dZ
ENRICH	@ n r I tS
ENROL	@ n r @U l
ENSUITE	O n s w i: t
ENSURE	@ n S o:
ENTANGLED	@ n t A N g @ l d
ENTER	E n t @
ENTERPRISE	E n t @ p r a: I z
ENTERPRISEBARGAINING	E n t @ p r a: I z b a: g @ n I N
ENTERTAIN	E n t @ t EI n
ENTHUSIASM	@ n T u: z i: A z @ m
ENTICE	@ n t a: I s
ENTIRE	@ n t a: I@
ENTITLE	@ n t a: I t @ l
ENTRANCE	E n t r @ n s
ENTRANT	E n t r @ n t
ENTREAT	@ n t r i: t
ENTREE	O n t r EI
ENTREPRENEUR	O n t r @ p r @ n @:
ENTRY	E n t r i:
ENVELOPE	E n v @ l @U p
ENVIRONMENT	E n v a: I r @ n m @ n t
ENVY	E n v i:
EPIC	E p I k
EPIDEMIC	E p @ d E m I k
EPILEPSY	E p @ l E p s i:
EPISODE	E p @ s @U d
EPITOME	@ p I t @ m i:
EPOCH	i: p O k
EQUAL	i: k w @ l
EQUATOR	@ k w EI t @
EQUIP	@ k w I p
EQUIPMENT	@ k w I p m @ n t
EQUIVALENT	@ k w I v @ l @ n t
ERA	I@ r @
ERADICATE	@ r A d @ k EI t
ERASE	@ r EI z
ERECT	@ r E k t
ERODE	@ r @U d
EROTIC	@ r O t I k
ERR	@:
ERRAND	E r @ n d
ERRATIC	@ r A t I k
ERROR	E r @
ERUPT	@ r a p t
ESCALATE	E s k @ l EI t
ESCALATOR	E s k @ l EI t @
ESCAPADE	E s k @ p EI d
ESCAPE	@ s k EI p
ESCORT	@ s k o: t
ESKY	E s k i:
ESL	i: E s E l
ESPECIALLY	@ s p E S @ l i:
ESPIONAGE	E s p i: @ n a: Z
ESSAY	E s EI
ESSENCE	E s @ n s
ESSENTIAL	@ s E n S @ l
ESTABLISH	@ s t A b l I S
ESTABLISHMENT	@ s t A b l I S m @ n t
ESTATE	@ s t EI t
ESTATEAGENT	@ s t EI t EI dZ @ n t
ESTEEM	@ s t i: m
ESTIMATE	E s t @ m @ t
ESTIMATE	E s t @ m EI t
ESTRANGED	@ s t r EI n dZ d
ETC	E t s E t r @
ETCH	E tS
ETCHING	E tS I N
ETERNAL	@ t @: n @ l
ETHICS	E T I k s
ETHNIC	E T n I k
ETIQUETTE	E t I k @ t
EUCALYPTUS	j u: k @ l I p t @ s
EUTHANASIA	j u: T @ n EI Z @
EVACUATE	@ v A k j u: EI t
EVADE	@ v EI d
EVALUATE	@ v A l j u: EI t
EVAPORATE	@ v A p @ r EI t
EVE	i: v
EVEN	i: v @ n
EVENING	i: v n I N
EVENINGCLASS	i: v n I N k l a: s
EVENINGDRESS	i: v n I N d r E s
EVENT	@ v E n t
EVENTUALLY	@ v E n tS @ l i:
EVER	E v @
EVERGREEN	E v @ g r i: n
EVERY	E v r i:
EVERYBODY	E v r i: b O d i:
EVERYDAY	E v r i: d EI
EVERYONE	E v r i: w a n
EVERYTHING	E v r i: T I N
EVERYWHERE	E v r i: w E@
EVICT	@ v I k t
EVIDENCE	E v @ d @ n s
EVIDENT	E v @ d @ n t
EVIL	i: v @ l
EVOLUTION	E v @ l u: S @ n
EX-	E k s
EXACT	@ g z A k t
EXACTLY	@ g z A k t l i:
EXAGGERATE	@ g z A dZ @ r EI t
EXAM	@ g z A m
EXAMINATION	@ g z A m @ n EI S @ n
EXAMINE	@ g z A m @ n
EXAMPLE	@ g z A m p @ l
EXASPERATE	@ g z A s p @ r EI t
EXCAVATE	E k s k @ v EI t
EXCEED	@ k s i: d
EXCEL	@ k s E l
EXCELLENT	E k s @ l @ n t
EXCEPT	@ k s E p t
EXCEPTION	@ k s E p S @ n
EXCEPTIONAL	@ k s E p S @ n @ l
EXCESS	E k s E s
EXCHANGE	@ k s tS EI n dZ
EXCITE	@ k s a: I t
EXCITED	@ k s a: I t @ d
EXCITING	@ k s a: I t I N
EXCLAIM	@ k s k l EI m
EXCLAMATION	E k s k l @ m EI S @ n
EXCLUDE	@ k s k l u: d
EXCLUSIVE	@ k s k l u: s I v
EXCRETE	@ k s k r i: t
EXCRUCIATING	@ k s k r u: S i: EI t I N
EXCURSION	@ k s k @: S @ n
EXCUSE	@ k s k j u: s
EXECUTE	E k s @ k j u: t
EXECUTIVE	@ g z E k j @ t I v
EXECUTOR	@ g z E k j @ t @
EXEMPT	@ g z E m p t
EXERCISE	E k s @ s a: I z
EXERT	@ g z @: t
EXHALE	E k s h EI l
EXHAUST	@ g z o: s t
EXHAUSTIVE	@ g z o: s t I v
EXHIBIT	@ g z I b @ t
EXILE	E g z a: I l
EXIST	@ g z I s t
EXIT	E g z @ t
EXIT	E k s @ t
EXODUS	E k s @ d @ s
EXOTIC	@ g z O t I k
EXPAND	@ k s p A n d
EXPANSE	@ k s p A n s
EXPECT	@ k s p E k t
EXPEDITION	E k s p @ d I S @ n
EXPEL	@ k s p E l
EXPEND	@ k s p E n d
EXPENDITURE	E k s p E n d @ tS @
EXPENSE	@ k s p E n s
EXPENSIVE	@ k s p E n s I v
EXPERIENCE	@ k s p I@ r i: @ n s
EXPERIMENT	@ k s p E r @ m @ n t
EXPERT	E k s p @: t
EXPIRE	@ k s p a: I@
EXPLAIN	@ k s p l EI n
EXPLETIVE	@ k s p l i: t I v
EXPLODE	@ k s p l @U d
EXPLOIT	@ k s p l o: I t
EXPLORE	@ k s p l o:
EXPLOSION	@ k s p l @U Z @ n
EXPLOSIVE	E k s p l @U s I v
EXPORT	E k s p o: t
EXPORT	@ k s p o: t
EXPOSE	@ k s p @U z
EXPOSURE	@ k s p @U Z @
EXPRESS	@ k s p r E s
EXPRESSION	@ k s p r E S @ n
EXPRESSWAY	E k s p r E s w EI
EXPULSION	@ k s p a l S @ n
EXQUISITE	E k s k w I z @ t
EXTEND	@ k s t E n d
EXTENSION	@ k s t E n S @ n
EXTENSIVE	@ k s t E n s I v
EXTENT	@ k s t E n t
EXTERIOR	@ k s t I@ r i: @
EXTERMINATE	@ k s t @: m @ n EI t
EXTERNAL	@ k s t @: n @ l
EXTINCT	@ k s t I N k t
EXTINGUISH	@ k s t I N g w I S
EXTORTION	@ k s t o: S @ n
EXTRA	E k s t r @
EXTRACT	@ k s t r A k t
EXTRAORDINARY	@ k s t r o: d @ n r i:
EXTRAVAGANT	@ k s t r A v @ g @ n t
EXTREME	@ k s t r i: m
EXTREMISM	@ k s t r i: m I z @ m
EYE	a: I
EYEBROW	a: I b r a: U
EYELASH	a: I l A S
EYELID	a: I l I d
EYESIGHT	a: I s a: I t
EYESORE	a: I s o:
EYEWITNESS	a: I w I t n @ s
F	E f
FABLE	f EI b @ l
FABRIC	f A b r I k
FABRICATE	f A b r @ k EI t
FABULOUS	f A b j @ l @ s
FACADE	f @ s a: d
FACE	f EI s
FACELESS	f EI s l @ s
FACELIFT	f EI s l I f t
FACET	f A s @ t
FACILITATE	f @ s I l @ t EI t
FACILITY	f @ s I l @ t i:
FACSIMILE	f A k s I m @ l i:
FACT	f A k t
FACTION	f A k S @ n
FACTOR	f A k t @
FACTORY	f A k t r i:
FACTUAL	f A k tS u: @ l
FACULTY	f A k @ l t i:
FAD	f A d
FADE	f EI d
FAECES	f i: s i: z
FAG	f A g
FAHRENHEIT	f A r @ n h a: I t
FAIL	f EI l
FAILING	f EI l I N
FAILURE	f EI l j @
FAINT	f EI n t
FAIR	f E@
FAIRLY	f E@ l i:
FAIRWAY	f E@ w EI
FAIRY	f E@ r i:
FAIRYBREAD	f E@ r i: b r E d
FAIRYFLOSS	f E@ r i: f l O s
FAIRYTALE	f E@ r i: t EI l
FAITH	f EI T
FAITHFUL	f EI T f @ l
FAKE	f EI k
FALL	f o: l
FALLACY	f A l @ s i:
FALLIBLE	f A l @ b @ l
FALLOUT	f o: l a: U t
0	f O l s
FALTER	f o: l t @
FAME	f EI m
FAMILIAR	f @ m I l j @
FAMILY	f A m @ l i:
FAMILYALLOWANCE	f A m l i: @ l a: U@ n s
FAMILYLAW	f A m l i: l o:
FAMILYPLANNING	f A m l i: p l A n I N
FAMILYROOM	f A m l i: r u: m
FAMINE	f A m @ n
FAMISHED	f A m I S t
FAMOUS	f EI m @ s
FAN	f A n
FANATIC	f @ n A t I k
FANBELT	f A n b E l t
FANCIFUL	f A n s @ f @ l
FANCY	f A n s i:
FANG	f A N
FANTASTIC	f A n t A s t I k
FANTASY	f A n t @ s i:
FAR	f a:
FAR-FETCHED	f a: f E tS t
FAR-REACHING	f a: r i: tS I N
FAR-SIGHTED	f a: s a: I t @ d
FARCE	f a: s
FARE	f E@
FAREWELL	f E@ w E l
FARM	f a: m
FART	f a: t
FARTHER	f a: D @
FASCINATE	f A s @ n EI t
FASHION	f A S @ n
FAST	f a: s t
FASTFOOD	f a: s t f u: d
FASTEN	f a: s @ n
FAT	f A t
FATCAT	f A t k A t
FATAL	f EI t @ l
FATALISTIC	f EI t @ l I s t I k
FATALITY	f @ t A l @ t i:
FATE	f EI t
FATHER	f a: D @
FATHER-IN-LAW	f a: D @ r I n l o:
FATIGUE	f @ t i: g
FATSO	f A t s @U
FAULT	f O l t
FAUNA	f o: n @
FAVOUR	f EI v @
FAVOURABLE	f EI v @ r @ b @ l
FAVOURITE	f EI v @ r @ t
FAX	f A k s
FAZE	f EI z
FEAR	f I@
FEARFUL	f I@ f @ l
FEASIBLE	f i: z @ b @ l
FEAST	f i: s t
FEAT	f i: t
FEATHER	f E D @
FEATURE	f i: tS @
FEBRUARY	f E b r u: E r i:
FED	f E d
FEDERAL	f E d @ r @ l
FEDERATE	f E d @ r EI t
FEE	f i:
FEEBLE	f i: b @ l
FEED	f i: d
FEEDBACK	f i: d b A k
FEEL	f i: l
FEELER	f i: l @
FEELING	f i: l I N
FEET	f i: t
FEIGN	f EI n
FELL	f E l
FELLOW	f E l @U
FELONY	f E l @ n i:
FELT	f E l t
FEMALE	f i: m EI l
FEMININE	f E m @ n @ n
FEMINIST	f E m @ n @ s t
FENCE	f E n s
FENCING	f E n s I N
FEND	f E n d
FERAL	f E r @ l
FERMENT	f @ m E n t
FEROCIOUS	f @ r @U S @ s
FERRISWHEEL	f E r @ s w i: l
FERRY	f E r i:
FERTILE	f @: t a: I l
FERTILISATION	f @: t @ l a: I z EI S @ n
FERTILISER	f @: t @ l a: I z @
FERVENT	f @: v @ n t
FESTER	f E s t @
FESTIVAL	f E s t @ v @ l
FESTIVE	f E s t I v
FESTOON	f E s t u: n
FETCH	f E tS
FETE	f EI t
FETID	f E t @ d
FETUS	f i: t @ s
FEUD	f j u: d
FEVER	f i: v @
FEW	f j u:
FIANCE	f i: O n s EI
FIANCEE	f i: O n s EI
FIASCO	f i: A s k @U
FIB	f I b
FIBRE	f a: I b @
FIBREGLASS	f a: I b @ g l a: s
FIBRO	f a: I b r @U
FICTION	f I k S @ n
FIDDLE	f I d @ l
FIDDLY	f I d l i:
FIDELITY	f @ d E l @ t i:
FIDGET	f I dZ @ t
FIELD	f I@ l d
FIERCE	f I@ s
FIERY	f a: I@ r i:
FIFTEEN	f I f t i: n
FIFTEENTH	f I f t i: n T
FIFTH	f I f T
FIFTY	f I f t i:
FIGHT	f a: I t
FIGMENT	f I g m @ n t
FIGURE	f I g @
FILE	f a: I l
FILIAL	f I l i: @ l
FILING	f a: I l I N
FILIPINO	f I l @ p i: n @U
FILL	f I l
FILLET	f I l @ t
FILLING	f I l I N
FILM	f I l m
FILTER	f I l t @
FILTHY	f I l T i:
FIN	f I n
FINAL	f a: I n @ l
FINALE	f @ n a: l i:
FINALISE	f a: I n @ l a: I z
FINALIST	f a: I n @ l @ s t
FINALLY	f a: I n @ l i:
FINANCE	f a: I n A n s
FINANCIAL	f @ n A n S @ l
FIND	f a: I n d
FINE	f a: I n
FINGER	f I N g @
FINGERNAIL	f I N g @ n EI l
FINGERPRINT	f I N g @ p r I n t
FINICKY	f I n I k i:
FINISH	f I n I S
FINITE	f a: I n a: I t
FIRE	f a: I@
FIREARM	f a: I@ r a: m
FIREBREAK	f a: I@ b r EI k
FIREFIGHTER	f a: I@ f a: I t @
FIREPLACE	f a: I@ p l EI s
FIREPROOF	f a: I@ p r u: f
FIREWOOD	f a: I@ w U d
FIREWORKS	f a: I@ w @: k s
FIRM	f @: m
FIRST	f @: s t
FIRST-CLASS	f @: s t k l a: s
FIRST-HAND	f @: s t h A n d
FISH	f I S
FISHERMAN	f I S @ m @ n
FISHY	f I S i:
FIST	f I s t
FIT	f I t
FITNESS	f I t n @ s
FITTING	f I t I N
FIVE	f a: I v
FIX	f I k s
FIXTURE	f I k s tS @
FIZZ	f I z
FIZZER	f I z @
FIZZLE	f I z @ l
FLAB	f l A b
FLABBERGASTED	f l A b @ g A s t @ d
FLABBERGASTED	f l A b @ g a: s t @ d
FLACCID	f l A s @ d
FLAG	f l A g
FLAGON	f l A g @ n
FLAGRANT	f l EI g r @ n t
FLAIR	f l E@
FLAK	f l A k
FLAKE	f l EI k
FLAMBOYANT	f l A m b o: I@ n t
FLAME	f l EI m
FLAMING	f l EI m I N
FLAMMABLE	f l A m @ b @ l
FLAN	f l A n
FLANK	f l A N k
FLANNEL	f l A n @ l
FLANNELETTE	f l A n @ l E t
FLAP	f l A p
FLAPJACK	f l A p dZ A k
FLARE	f l E@
FLASH	f l A S
FLASHFLOOD	f l A S f l a d
FLASHBACK	f l A S b A k
FLASHLIGHT	f l A S l a: I t
FLASHY	f l A S i:
FLASK	f l a: s k
FLAT	f l A t
FLATETTE	f l A t E t
FLATTEN	f l A t @ n
FLATTER	f l A t @
FLATULENCE	f l A tS @ l @ n s
FLAUNT	f l o: n t
FLAUTIST	f l o: t @ s t
FLAVOUR	f l EI v @
FLAW	f l o:
FLAX	f l A k s
FLEA	f l i:
FLEAMARKET	f l i: m a: k @ t
FLEA-BITTEN	f l i: b I t @ n
FLED	f l E d
FLEDGLING	f l E dZ l I N
FLEE	f l i:
FLEECE	f l i: s
FLEET	f l i: t
FLEETING	f l i: t I N
FLESH	f l E S
FLEW	f l u:
FLEX	f l E k s
FLEXIBLE	f l E k s @ b @ l
FLEXITIME	f l E k s i: t a: I m
FLICK	f l I k
FLICKER	f l I k @
FLIGHT	f l a: I t
FLIMSY	f l I m z i:
FLINCH	f l I n tS
FLING	f l I N
FLINT	f l I n t
FLIP	f l I p
FLIPPANT	f l I p @ n t
FLIPPER	f l I p @
FLIRT	f l @: t
FLIT	f l I t
FLOAT	f l @U t
FLOCK	f l O k
FLOG	f l O g
FLOOD	f l a d
FLOODLIGHT	f l a d l a: I t
FLOOR	f l o:
FLOORBOARD	f l o: b o: d
FLOP	f l O p
FLOPPY	f l O p i:
FLORA	f l o: r @
FLORAL	f l O r @ l
FLORIST	f l O r @ s t
FLOSS	f l O s
FLOUR	f l a: U@
FLOURISH	f l a r I S
FLOUT	f l a: U t
FLOW	f l @U
FLOWER	f l a: U@
FLOWERBED	f l a: U@ b E d
FLOWERY	f l a: U@ r i:
FLOWN	f l @U n
FLU	f l u:
FLUCTUATE	f l a k tS u: EI t
FLUE	f l u:
FLUENT	f l u: @ n t
FLUFF	f l a f
FLUID	f l u: @ d
FLUKE	f l u: k
FLUNK	f l a N k
FLUORESCENT	f l U@ r E s @ n t
FLUORIDE	f l U@ r a: I d
FLURRY	f l a r i:
FLUSH	f l a S
FLUSTER	f l a s t @
FLUTE	f l u: t
FLUTTER	f l a t @
FLY	f l a: I
FLYINGSAUCER	f l a: I I N s o: s @
FOAL	f @U l
FOAM	f @U m
FOB	f O b
FOCUS	f @U k @ s
FODDER	f O d @
FOETUS	f i: t @ s
FOG	f O g
FOIL	f o: I l
FOLD	f @U l d
FOLDER	f @U l d @
FOLIAGE	f @U l i: I dZ
FOLK	f @U k
FOLKLORE	f @U k l o:
FOLLOW	f O l @U
FOLLOW-UP	f O l @U a p
FOLLOWER	f O l @U @
FOLLOWING	f O l @U I N
FOLLY	f O l i:
FOND	f O n d
FOOD	f u: d
FOODSTUFF	f u: d s t a f
FOOL	f u: l
FOOLPROOF	f u: l p r u: f
FOOT	f U t
FOOTBALL	f U t b o: l
FOOTING	f U t I N
FOOTNOTE	f U t n @U t
FOOTPATH	f U t p a: T
FOOTPRINT	f U t p r I n t
FOOTSTEP	f U t s t E p
FOOTWEAR	f U t w E@
FOR	f o:
FORAGE	f O r I dZ
FORBEARANCE	f o: b E@ r @ n s
FORBID	f @ b I d
FORBIDDING	f @ b I d I N
FORCE	f o: s
FORCEFUL	f o: s f U l
FORCEPS	f o: s @ p s
FORCIBLE	f o: s @ b @ l
FORD	f o: d
FORE	f o:
FOREARM	f o: r a: m
FOREBEAR	f o: b E@
FORECAST	f o: k a: s t
FOREFINGER	f o: f I N g @
FOREGROUND	f o: g r a: U n d
FOREHEAD	f O r @ d
FOREIGN	f O r @ n
FOREMAN	f o: m @ n
FOREMOST	f o: m @U s t
FORENSIC	f @ r E n z I k
FORENSIC	f @ r E n s I k
FORESEE	f o: s i:
FORESHADOW	f o: S A d @U
FOREST	f O r @ s t
FORESTRY	f O r @ s t r i:
FOREVER	f @ r E v @
FOREWORD	f o: w @: d
FORFEIT	f o: f @ t
FORGE	f o: dZ
FORGET	f @ g E t
FORGIVE	f @ g I v
FORK	f o: k
FORKLIFT	f o: k l I f t
FORLORN	f @ l o: n
FORM	f o: m
FORMAL	f o: m @ l
FORMAT	f o: m A t
FORMATION	f o: m EI S @ n
FORMER	f o: m @
FORMIDABLE	f o: m @ d @ b @ l
FORMIDABLE	f o: m I d @ b @ l
FORMULA	f o: m j @ l @
FORMULATE	f o: m j @ l EI t
FORSAKE	f @ s EI k
FORT	f o: t
FORTE	f o: t EI
FORTH	f o: T
FORTHCOMING	f o: T k a m I N
FORTHRIGHT	f o: T r a: I t
FORTIFY	f o: t @ f a: I
FORTNIGHT	f o: t n a: I t
FORTRESS	f o: t r @ s
FORTUNATE	f o: tS @ n @ t
FORTUNE	f o: tS @ n
FORTY	f o: t i:
FORUM	f o: r @ m
FORWARD	f o: w @ d
FOSSICK	f O s I k
FOSSIL	f O s @ l
FOSTER	f O s t @
FOUGHT	f o: t
FOUL	f a: U l
FOUL-MOUTHED	f a: U l m a: U D d
FOUND	f a: U n d
FOUNDATION	f a: U n d EI S @ n
FOUNTAIN	f a: U n t @ n
FOUNTAINPEN	f a: U n t @ n p E n
FOUR	f o:
FOUR-LETTERWORD	f o: l E t @ w @: d
FOUR-WHEELDRIVE	f o: w i: l d r a: I v
FOURTEEN	f o: t i: n
FOURTEENTH	f o: t i: n T
FOURTH	f o: T
FOX	f O k s
FOYER	f o: I@
FRACTION	f r A k S @ n
FRACTURE	f r A k tS @
FRAGILE	f r A dZ a: I l
FRAGMENT	f r A g m @ n t
FRAGRANCE	f r EI g r @ n s
FRAIL	f r EI l
FRAME	f r EI m
FRAMEWORK	f r EI m w @: k
FRANCHISE	f r A n tS a: I z
FRANK	f r A N k
FRANKFURT	f r A N k f @ t
FRANTIC	f r A n t I k
FRATERNAL	f r @ t @: n @ l
FRAUD	f r o: d
FRAUGHT	f r o: t
FRAY	f r EI
FRAZZLED	f r A z @ l d
FREAK	f r i: k
FRECKLE	f r E k @ l
FREE	f r i:
FREE-FOR-ALL	f r i: f @ r o: l
FREE-RANGE	f r i: r EI n dZ
FREEBIE	f r i: b i:
FREEDOM	f r i: d @ m
FREEHAND	f r i: h A n d
FREEHOLD	f r i: h @U l d
FREELANCE	f r i: l A n s
FREELOADER	f r i: l @U d @
FREESTYLE	f r i: s t a: I l
FREEWAY	f r I w EI
FREEZE	f r i: z
FREEZE-DRY	f r i: z d r a: I
FREEZER	f r i: z @
FREIGHT	f r EI t
FRENCH	f r E n tS
FRENETIC	f r @ n E t I k
FRENZY	f r E n z i:
FREQUENCY	f r i: k w @ n s i:
FREQUENT	f r i: k w @ n t
FRESH	f r E S
FRESHWATER	f r E S w o: t @
FRET	f r E t
FRICTION	f r I k S @ n
FRIDAY	f r a: I d EI
FRIDGE	f r I dZ
FRIED	f r a: I d
FRIEND	f r E n d
FRIENDLY	f r E n d l i:
FRIENDSHIP	f r E n d S I p
FRIGHT	f r a: I t
FRIGHTEN	f r a: I t @ n
FRIGHTFUL	f r a: I t f U l
FRILL	f r I l
FRINGE	f r I n dZ
FRISK	f r I s k
FRITTER	f r I t @
FRIVOLOUS	f r I v @ l @ s
FRIZZY	f r I z i:
FROCK	f r O k
FROG	f r O g
FROGMAN	f r O g m @ n
FROLIC	f r O l I k
FROM	f r O m
FRONT	f r a n t
FRONTIER	f r a n t I@
FROST	f r O s t
FROSTBITE	f r O s t b a: I t
FROTH	f r O T
FROWN	f r a: U n
FROZE	f r @U z
FROZEN	f r @U z @ n
FRUGAL	f r u: g @ l
FRUIT	f r u: t
FRUITCAKE	f r u: t k EI k
FRUSTRATE	f r a s t r EI t
FRY	f r a: I
FUCK	f a k
FUCKWIT	f a k w I t
FUDGE	f a dZ
FUEL	f j u: @ l
FUGITIVE	f j u: dZ @ t I v
FULFIL	f U l f I l
FULL	f U l
FULLSTOP	f U l s t O p
FULL-TIME	f U l t a: I m
FULLY-FLEDGED	f U l i: f l E dZ d
FUMBLE	f a m b @ l
FUME	f j u: m
FUMIGATE	f j u: m @ g EI t
FUN	f a n
FUNCTION	f a N k S @ n
FUNCTIONAL	f a N k S @ n @ l
FUND	f a n d
FUNDAMENTAL	f a n d @ m E n t @ l
FUNERAL	f j u: n r @ l
FUNGUS	f a N g @ s
FUNNEL	f a n @ l
FUNNEL-WEB	f a n @ l w E b
FUNNY	f a n i:
FUR	f @:
FURIOUS	f j u: r i: @ s
FURNACE	f @: n @ s
FURNISH	f @: n I S
FURNITURE	f @: n I tS @
FURORE	f j u: r o:
FURROW	f a r @U
FURTHER	f @: D @
FURTHEST	f @: D @ s t
FURTIVE	f @: t I v
FURY	f j u: r i:
FUSE	f j u: z
FUSS	f a s
FUSSY	f a s i:
FUTILE	f j u: t a: I l
FUTURE	f j u: tS @
FUTURETENSE	f j u: tS @ t E n s
FUZZ	f a z
FUZZY	f a z i:
G	dZ i:
GABLE	g EI b @ l
GADGET	g A dZ @ t
GAG	g A g
GAGGLE	g A g @ l
GAIETY	g EI @ t i:
GAIN	g EI n
GAIT	g EI t
GALA	g a: l @
GALAH	g @ l a:
GALAXY	g A l @ k s i:
GALE	g EI l
GALLBLADDER	g o: l b l A d @
GALLERY	g A l @ r i:
GALLON	g A l @ n
GALLOP	g A l @ p
GALLSTONE	g o: l s t @U n
GALLUPPOLL	g A l @ p p @U l
GALORE	g @ l o:
GALVANISE	g A l v @ n a: I z
GAMBLE	g A m b @ l
GAME	g EI m
GAMING	g EI m I N
GANG	g A N
GANGRENE	g A N g r i: n
GANGSTER	g A N s t @
GAOL	dZ EI l
GAP	g A p
GAPE	g EI p
GARAGE	g A r a: Z
GARBAGE	g a: b I dZ
GARDEN	g a: d @ n
GARDENER	g a: d n @
GARGLE	g a: g @ l
GARISH	g E@ r I S
GARLIC	g a: l I k
GARMENT	g a: m @ n t
GARNISH	g a: n I S
GARRET	g A r @ t
GAS	g A s
GASH	g A S
GASKET	g A s k @ t
GASP	g A s p
GASTRIC	g A s t r I k
GATE	g EI t
GATECRASH	g EI t k r A S
GATHER	g A D @
GAUDY	g o: d i:
GAUGE	g EI dZ
GAUNT	g o: n t
GAUZE	g o: z
GAVE	g EI v
GAWK	g o: k
GAWKY	g o: k i:
GAY	g EI
GAZE	g EI z
GAZUMP	g @ z a m p
GDP	dZ i: d i: p i:
GEAR	g I@
GEL	dZ E l
GELATINE	dZ E l @ t i: n
GEM	dZ E m
GENDER	dZ E n d @
GENE	dZ i: n
GENERAL	dZ E n r @ l
GENERATE	dZ E n @ r EI t
GENERATION	dZ E n @ r EI S @ n
GENERIC	dZ @ n E r I k
GENEROUS	dZ E n @ r @ s
GENESIS	dZ E n @ s @ s
GENETICS	dZ @ n E t I k s
GENIAL	dZ i: n i: @ l
GENITALS	dZ E n @ t @ l z
GENIUS	dZ i: n i: @ s
GENOCIDE	dZ E n @ s a: I d
GENRE	Z O n r @
GENTILE	dZ E n t a: I l
GENTLE	dZ E n t @ l
GENTLEMAN	dZ E n t @ l m @ n
GENUINE	dZ E n j u: @ n
GEOGRAPHY	dZ i: O g r @ f i:
GEOLOGY	dZ i: O l @ dZ i:
GEOMETRY	dZ i: O m @ t r i:
GERIATRIC	dZ E r i: A t r I k
GERIATRICS	dZ E r i: A t r I k s
GERM	dZ @: m
GERMAN	dZ @: m @ n
GERRYMANDER	dZ E r i: m A n d @
GESTICULATE	dZ E s t I k j @ l EI t
GESTURE	dZ E s tS @
GET	g E t
GHASTLY	g a: s t l i:
GHERKIN	g @: k @ n
GHETTO	g E t @U
GHOST	g @U s t
GIANT	dZ a: I@ n t
GIBBER	dZ I b @
GIBBERISH	dZ I b @ r I S
GIDDY	g I d i:
GIFT	g I f t
GIGANTIC	dZ a: I g A n t I k
GIGGLE	g I g @ l
GILD	g I l d
GILT	g I l t
GIMMICK	g I m I k
GINGER	dZ I n dZ @
GINGERLY	dZ I n dZ @ l i:
GINGHAM	g I N @ m
GIPSY	dZ I p s i:
GIRL	g @: l
GIRLFRIEND	g @: l f r E n d
GIRLS	g @: l z
GIRTH	g @: T
GIST	dZ I s t
GIVE	g I v
GIVENNAME	g I v @ n n EI m
GLACIER	g l EI s i: @
GLAD	g l A d
GLAMOUR	g l A m @
GLANCE	g l A n s
GLAND	g l A n d
GLARE	g l E@
GLARING	g l E@ r I N
GLASS	g l a: s
GLEAM	g l i: m
GLEAN	g l i: n
GLEE	g l i:
GLIB	g l I b
GLIDE	g l a: I d
GLIMMER	g l I m @
GLIMPSE	g l I m p s
GLINT	g l I n t
GLISTEN	g l I s @ n
GLITTER	g l I t @
GLOAT	g l @U t
GLOBE	g l @U b
GLOOMY	g l u: m i:
GLORIOUS	g l o: r i: @ s
GLORY	g l o: r i:
GLOSS	g l O s
GLOSSARY	g l O s @ r i:
GLOVE	g l a v
GLOW	g l @U
GLUCOSE	g l u: k @U s
GLUE	g l u:
GLUM	g l a m
GLUT	g l a t
GLUTTON	g l a t @ n
GNASH	n A S
GNAW	n o:
GNP	dZ i: E n p i:
GO	g @U
GOAL	g @U l
GOALKEEPER	g @U l k i: p @
GOAT	g @U t
GOBBLE	g O b @ l
GOD	g O d
GOGGLE	g O g @ l
GOLD	g @U l d
GOLDEN	g @U l d @ n
GOLDENSYRUP	g @U l d @ n s I r @ p
GOLDMINE	g @U l d m a: I n
GOLF	g O l f
GONE	g O n
GONORRHOEA	g O n @ r i: @
GOOD	g U d
GOODBYE	g U d b a: I
GOODNESS	g U d n @ s
GOODS	g U d z
GOOSE	g u: s
GORGE	g o: dZ
GORGEOUS	g o: dZ @ s
GOSH	g O S
GOSSIP	g O s @ p
GOT	g O t
GOUGE	g a: U dZ
GOURMET	g o: m EI
GOUT	g a: U t
GOVERN	g a v @ n
GOVERNMENT	g a v @ n m @ n t
GOVERNOR	g a v @ n @
GOVERNOR-GENERAL	g a v @ n @ dZ E n r @ l
GOWN	g a: U n
GP	dZ i: p i:
GPO	dZ i: p i: @U
GRAB	g r A b
GRACE	g r EI s
GRACIOUS	g r EI S @ s
GRADE	g r EI d
GRADUAL	g r A dZ u: @ l
GRADUATE	g r A dZ u: @ t
GRAFFITI	g r @ f i: t i:
GRAFT	g r a: f t
GRAIN	g r EI n
GRAM	g r A m
GRAMMAR	g r A m @
GRAN	g r A n
GRAND	g r A n d
GRANDCHILD	g r A n tS a: I l d
GRANDDAUGHTER	g r A n d o: t @
GRANDFATHER	g r A n f a: D @
GRANDIOSE	g r A n d i: @U s
GRANDMOTHER	g r A n m a D @
GRANDPARENT	g r A n p E@ r @ n t
GRANDSON	g r A n s a n
GRANDSTAND	g r A n s t A n d
GRANITE	g r A n @ t
GRANNYSMITH	g r A n i: s m I T
GRANT	g r A n t
GRAPE	g r EI p
GRAPH	g r A f
GRAPHIC	g r A f I k
GRAPHITE	g r A f a: I t
GRAPPLE	g r A p @ l
GRASP	g r A s p
GRASPING	g r A s p I N
GRASS	g r a: s
GRASSROOTS	g r a: s r u: t s
GRATE	g r EI t
GRATEFUL	g r EI t f U l
GRATER	g r EI t @
GRATING	g r EI t I N
GRATITUDE	g r A t @ tS u: d
GRAVE	g r EI v
GRAVEL	g r A v @ l
GRAVEYARD	g r EI v j a: d
GRAVITATE	g r A v @ t EI t
GRAVITY	g r A v @ t i:
GRAVY	g r EI v i:
GRAZE	g r EI z
GRAZIER	g r EI z i: @
GREASE	g r i: s
GREASEPROOF	g r i: s p r u: f
GREAT	g r EI t
GREEDY	g r i: d i:
GREEK	g r i: k
GREEN	g r i: n
GREENGROCER	g r i: n g r @U s @
GREENHOUSE	g r i: n h a: U s
GREET	g r i: t
GREETING	g r i: t I N
GRENADE	g r @ n EI d
GREVILLEA	g r @ v I l i: @
GREW	g r u:
GREY	g r EI
GRID	g r I d
GRIEF	g r i: f
GRIEVANCE	g r i: v @ n s
GRILL	g r I l
GRILLE	g r I l
GRIM	g r I m
GRIMACE	g r I m @ s
GRIME	g r a: I m
GRIN	g r I n
GRIND	g r a: I n d
GRIP	g r I p
GRIPE	g r a: I p
GRISLY	g r I z l i:
GRISTLE	g r I s @ l
GRIT	g r I t
GRIZZLE	g r I z @ l
GROAN	g r @U n
GROCER	g r @U s @
GROCERIES	g r @U s @ r i: z
GROG	g r O g
GROGGY	g r O g i:
GROIN	g r o: I n
GROOM	g r u: m
GROOMSMAN	g r u: m z m @ n
GROOVE	g r u: v
GROPE	g r @U p
GROSS	g r @U s
GROTESQUE	g r @U t E s k
GROTTY	g r O t i:
GROUCH	g r a: U tS
GROUND	g r a: U n d
GROUNDWORK	g r a: U n d w @: k
GROUP	g r u: p
GROUT	g r a: U t
GROVE	g r @U v
GROVEL	g r O v @ l
GROW	g r @U
GROWL	g r a: U l
GROWN	g r @U n
GROWTH	g r @U T
GRUB	g r a b
GRUBBY	g r a b i:
GRUDGE	g r a dZ
GRUDGING	g r a dZ I N
GRUELLING	g r u: @ l I N
GRUESOME	g r u: s @ m
GRUFF	g r a f
GRUMBLE	g r a m b @ l
GRUMPY	g r a m p i:
GRUNT	g r a n t
GUARANTEE	g A r @ n t i:
GUARD	g a: d
GUARDIAN	g a: d i: @ n
GUERILLA	g @ r I l @
GUESS	g E s
GUEST	g E s t
GUFFAW	g a f o:
GUIDANCE	g a: I d @ n s
GUIDE	g a: I d
GUILE	g a: I l
GUILT	g I l t
GUITAR	g @ t a:
GULF	g a l f
GULLET	g a l @ t
GULLIBLE	g a l @ b @ l
GULLY	g a l i:
GULP	g a l p
GUM	g a m
GUMBOOT	g a m b u: t
GUN	g a n
GURGLE	g @: g @ l
GUSH	g a S
GUST	g a s t
GUSTO	g a s t @U
GUT	g a t
GUTTER	g a t @
GUY	g a: I
GUZZLE	g a z @ l
GYM	dZ I m
GYMNASIUM	dZ I m n EI z i: @ m
GYMNASTICS	dZ I m n A s t I k s
GYNAECOLOGIST	g a: I n @ k O l @ dZ @ s t
GYPSY	dZ I p s i:
H	EI tS
HABIT	h A b @ t
HABITAT	h A b @ t A t
HACK	h A k
HACKSAW	h A k s o:
HAD	h A d
HADN'T	h A d @ n t
HAEMOGLOBIN	h i: m @ g l @U b @ n
HAEMOPHILIA	h i: m @ f I l i: @
HAEMORRHAGE	h E m @ r I dZ
HAEMORRHOID	h E m @ r o: I d
HAGGARD	h A g @ d
HAGGLE	h A g @ l
HAIL	h EI l
HAIR	h E@
HAIR-RAISING	h E@ r EI z I N
HAIRCUT	h E@ k a t
HAIRDO	h E@ d u:
HAIRDRESSER	h E@ d r E s @
HAIRSTYLE	h E@ s t a: I l
HALF	h a: f
HALF-BROTHER	h a: f b r a D @
HALF-HEARTED	h a: f h a: t @ d
HALF-SISTER	h a: f s I s t @
HALFWAY	h a: f w EI
HALL	h o: l
HALLMARK	h o: l m a: k
HALLUCINATE	h @ l u: s @ n EI t
HALLWAY	h o: l w EI
HALO	h EI l @U
HALT	h o: l t
HALVE	h a: v
HAM	h A m
HAMBURGER	h A m b @: g @
HAMMER	h A m @
HAMMOCK	h A m @ k
HAMPER	h A m p @
HAMSTRING	h A m s t r I N
HAND	h A n d
HANDBAG	h A n d b A g
HANDCUFFS	h A n d k a f s
HANDFUL	h A n d f U l
HANDICAP	h A n d i: k A p
HANDICRAFT	h A n d i: k r a: f t
HANDKERCHIEF	h A N k @ tS @ f
HANDKERCHIEF	h A N k @ tS i: f
HANDLE	h A n d @ l
HANDMADE	h A n m EI d
HANDOUT	h A n d a: U t
HANDS-ON	h A n d z O n
HANDSHAKE	h A n d S EI k
HANDSOME	h A n s @ m
HANDWRITING	h A n d r a: I t I N
HANDY	h A n d i:
HANG	h A N
HANG-GLIDER	h A N g l a: I d @
HANG-UP	h A N a p
HANGAR	h A N @
HANGER	h A N @
HANGOVER	h A N @U v @
HANKIE	h A N k i:
HAPHAZARD	h A p h A z @ d
HAPPEN	h A p @ n
HAPPY	h A p i:
HARASS	h @ r A s
HARASS	h A r @ s
HARBOUR	h a: b @
HARD	h a: d
HARDLY	h a: d l i:
HARDSHIP	h a: d S I p
HARDWARE	h a: d w E@
HARDY	h a: d i:
HARM	h a: m
HARMONY	h a: m @ n i:
HARNESS	h a: n @ s
HARP	h a: p
HARPOON	h a: p u: n
HARSH	h a: S
HARVEST	h a: v @ s t
HAS	h A z
HASH	h A S
HASSLE	h A s @ l
HASTE	h EI s t
HAT	h A t
HAT-TRICK	h A t t r I k
HATCH	h A tS
HATCHBACK	h A tS b A k
HATCHET	h A tS @ t
HATE	h EI t
HAUGHTY	h o: t i:
HAUL	h o: l
HAUNT	h o: n t
HAVE	h A v
HAVEN	h EI v @ n
HAVOC	h A v @ k
HAWK	h o: k
HAY	h EI
HAYFEVER	h EI f i: v @
HAYWIRE	h EI w a: I@
HAZARD	h A z @ d
HAZE	h EI z
HAZEL	h EI z @ l
HE	h i:
HEAD	h E d
HEADSTART	h E d s t a: t
HEAD-ON	h E d O n
HEADACHE	h E d EI k
HEADING	h E d I N
HEADLAND	h E d l @ n d
HEADLAND	h E d l A n d
HEADLIGHT	h E d l a: I t
HEADLINE	h E d l a: I n
HEADQUARTERS	h E d k w o: t @ z
HEADSTONE	h E d s t @U n
HEADSTRONG	h E d s t r O N
HEADTEACHER	h E d t i: tS @
HEADWAY	h E d w EI
HEADWIND	h E d w I n d
HEAL	h i: l
HEALTH	h E l T
HEAP	h i: p
HEAR	h I@
HEARING	h I@ r I N
HEARINGAID	h I@ r I N EI d
HEARSAY	h I@ s EI
HEARSE	h @: s
HEART	h a: t
HEARTACHE	h a: t EI k
HEARTBREAK	h a: t b r EI k
HEARTBURN	h a: t b @: n
HEARTEN	h a: t @ n
HEARTLESS	h a: t l @ s
HEARTY	h a: t i:
HEAT	h i: t
HEATER	h i: t @
HEATWAVE	h i: t w EI v
HEAVE	h i: v
HEAVEN	h E v @ n
HEAVY	h E v i:
HECKLE	h E k @ l
HECTARE	h E k t E@
HECTIC	h E k t I k
HEDGE	h E dZ
HEEL	h i: l
HEFTY	h E f t i:
HEIFER	h E f @
HEIGHT	h a: I t
HEIGHTEN	h a: I t @ n
HEIGHTS	h a: I t s
HEIR	E@
HEIRLOOM	E@ l u: m
HELD	h E l d
HELICOPTER	h E l i: k O p t @
HELIPORT	h E l i: p o: t
HELL	h E l
HELLO	h a l @U
HELM	h E l m
HELMET	h E l m @ t
HELP	h E l p
HELPING	h E l p I N
HELPLESS	h E l p l @ s
HEM	h E m
HEMISPHERE	h E m @ s f I@
HEMLINE	h E m l a: I n
HEMP	h E m p
HEN	h E n
HENCE	h E n s
HENCEFORTH	h E n s f o: T
HEPATITIS	h E p @ t a: I t @ s
HER	h @:
HERALD	h E r @ l d
HERB	h @: b
HERD	h @: d
HERE	h I@
HEREDITY	h @ r E d @ t i:
HERESY	h E r @ s i:
HERITAGE	h E r @ t I dZ
HERMIT	h @: m @ t
HERNIA	h @: n i: @
HERO	h I@ r @U
HEROIN	h E r @ w @ n
HEROINE	h E r @ w @ n
HERPES	h @: p i: z
HERS	h @: z
HERSELF	h @ s E l f
HESITATE	h E z @ t EI t
HETEROSEXUAL	h E t @ r @U s E k S u: @ l
HETEROSEXUAL	h E t r @ s E k S u: @ l
HEW	h j u:
HEYDAY	h EI d EI
HI-FI	h a: I f a: I
HIBERNATE	h a: I b @ n EI t
HICCUP	h I k a p
HIDDEN	h I d @ n
HIDE	h a: I d
HIDEAWAY	h a: I d @ w EI
HIDEOUS	h I d i: @ s
HIERARCHY	h a: I@ r a: k i:
HIGH	h a: I
HIGHSCHOOL	h a: I s k u: l
HIGHSEASON	h a: I s i: z @ n
HIGHBROW	h a: I b r a: U
HIGHLAND	h a: I l @ n d
HIGHLIGHT	h a: I l a: I t
HIGHLIGHTER	h a: I l a: I t @
HIGHLY	h a: I l i:
HIGHWAY	h a: I w EI
HIJACK	h a: I dZ A k
HIKE	h a: I k
HILARIOUS	h @ l E@ r i: @ s
HILL	h I l
HILT	h I l t
HIM	h I m
HIMSELF	h I m s E l f
HIND	h a: I n d
HINDER	h I n d @
HINDSIGHT	h a: I n d s a: I t
HINDUISM	h I n d u: I z @ m
HINGE	h I n dZ
HINT	h I n t
HIP	h I p
HIRE	h a: I@
HIRE-PURCHASE	h a: I@ p @: tS @ s
HIS	h I z
HISS	h I s
HISTORIC	h I s t O r I k
HISTORICAL	h I s t O r I k @ l
HISTORY	h I s t r i:
HIT	h I t
HIT-AND-RUN	h I t @ n r a n
HITCH	h I tS
HITCHHIKE	h I tS h a: I k
HITHERTO	h I D @ t u:
HIVE	h a: I v
HOARD	h o: d
HOARDING	h o: d I N
HOARSE	h o: s
HOAX	h @U k s
HOBBLE	h O b @ l
HOBBY	h O b i:
HOBBYHORSE	h O b i: h o: s
HOCKEY	h O k i:
HOE	h @U
HOG	h O g
HOIST	h o: I s t
HOLD	h @U l d
HOLD-UP	h @U l d a p
HOLE	h @U l
HOLIDAY	h O l @ d EI
HOLLOW	h O l @U
HOLOCAUST	h O l @ k O s t
HOLOGRAM	h O l @ g r A m
HOLSTER	h @U l s t @
HOLY	h @U l i:
HOMAGE	h O m I dZ
HOME	h @U m
HOMEUNIT	h @U m j u: n @ t
HOMELAND	h @U m l A n d
HOMESICK	h @U m s I k
HOMESTEAD	h @U m s t E d
HOMEWORK	h @U m w @: k
HOMICIDE	h O m @ s a: I d
HOMOEOPATHY	h @U m i: O p @ T i:
HOMOGENEOUS	h @U m @ dZ i: n i: @ s
HOMOSEXUAL	h @U m @U s E k S u: @ l
HOMOSEXUAL	h @U m @ s E k S u: @ l
HONEST	O n @ s t
HONEY	h a n i:
HONEYCOMB	h a n i: k @U m
HONEYMOON	h a n i: m u: n
HONORARY	O n @ r @ r i:
HONOUR	O n @
HONOURABLE	O n @ r @ b @ l
HOOD	h U d
HOODLUM	h u: d l @ m
HOODWINK	h U d w I N k
HOOF	h U f
HOOF	h u: f
HOOK	h U k
HOOLIGAN	h u: l @ g @ n
HOOLIGAN	h u: l i: g @ n
HOON	h u: n
HOOP	h u: p
HOP	h O p
HOPE	h @U p
HOPEFUL	h @U p f U l
HOPELESS	h @U p l @ s
HORDE	h o: d
HORIZON	h @ r a: I z @ n
HORIZONTAL	h O r @ z O n t @ l
HORMONE	h o: m @U n
HORN	h o: n
HOROSCOPE	h O r @ s k @U p
HORRENDOUS	h @ r E n d @ s
HORRIBLE	h O r @ b @ l
HORRIFY	h O r @ f a: I
HORROR	h O r @
HORSDOEUVRE	o: d @: v
HORSE	h o: s
HORSESHOE	h o: s S u:
HORTICULTURE	h o: t @ k a l tS @
HOSE	h @U z
HOSIERY	h @U Z @ r i:
HOSPICE	h O s p @ s
HOSPITAL	h O s p @ t @ l
HOSPITALITY	h O s p @ t A l @ t i:
HOST	h @U s t
HOSTAGE	h O s t I dZ
HOSTEL	h O s t E l
HOSTEL	h O s t @ l
HOSTILE	h O s t a: I l
HOT	h O t
HOTCHIPS	h O t tS I p s
HOTDOG	h O t d O g
HOTEL	h @U t E l
HOTHOUSE	h O t h a: U s
HOTLINE	h O t l a: I n
HOTPLATE	h O t p l EI t
HOUND	h a: U n d
HOUR	a: U@
HOUSE	h a: U s
HOUSE-WARMING	h a: U s w o: m I N
HOUSEBREAKER	h a: U s b r EI k @
HOUSEHOLD	h a: U s h @U l d
HOUSEKEEPING	h a: U s k i: p I N
HOUSEWIFE	h a: U s w a: I f
HOUSEWORK	h a: U s w @: k
HOVEL	h O v @ l
HOVER	h O v @
HOVERCRAFT	h O v @ k r a: f t
HOW	h a: U
HOWEVER	h a: U E v @
HOWL	h a: U l
HQ	EI tS k j u:
HR	a: U@
HSC	EI tS E s s i:
HT	h a: I t
HUB	h a b
HUDDLE	h a d @ l
HUE	h j u:
HUG	h a g
HUGE	h j u: dZ
HULK	h a l k
HULL	h a l
HULLO	h a l @U
HUM	h a m
HUMAN	h j u: m @ n
HUMANE	h j u: m EI n
HUMANITARIAN	h j u: m A n @ t E@ r i: @ n
HUMANITY	h j u: m A n @ t i:
HUMBLE	h a m b @ l
HUMDRUM	h a m d r a m
HUMID	h j u: m @ d
HUMILIATE	h j u: m I l i: EI t
HUMILITY	h j u: m I l @ t i:
HUMOUR	h j u: m @
HUMP	h a m p
HUMPY	h a m p i:
HUNCH	h a n tS
HUNDRED	h a n d r @ d
HUNG	h a N
HUNGARIAN	h a N g E@ r i: @ n
HUNGER	h a N g @
HUNT	h a n t
HURDLE	h @: d @ l
HURL	h @: l
HURRAY	h @ r EI
HURRICANE	h a r @ k @ n
HURRY	h a r i:
HURT	h @: t
HURTFUL	h @: t f U l
HURTLE	h @: t @ l
HUSBAND	h a z b @ n d
HUSH	h a S
HUSK	h a s k
HUSKY	h a s k i:
HUSTLE	h a s @ l
HUT	h a t
HUTCH	h a tS
HWY	h a: I w EI
HYBRID	h a: I b r @ d
HYDRANT	h a: I d r @ n t
HYDRAULIC	h a: I d r O l I k
HYDRO-ELECTRIC	h a: I d r @U @ l E k t r I k
HYDROFOIL	h a: I d r @ f o: I l
HYDROPONICS	h a: I d r @ p O n I k s
HYGIENE	h a: I dZ i: n
HYMN	h I m
HYPE	h a: I p
HYPED-UP	h a: I p t a p
HYPHEN	h a: I f @ n
HYPNOSIS	h I p n @U s @ s
HYPOCHONDRIAC	h a: I p @ k O n d r i: A k
HYPOCRITE	h I p @ k r I t
HYPODERMIC	h a: I p @ d @: m I k
HYPOTHESIS	h a: I p O T @ s @ s
HYSTERECTOMY	h I s t @ r E k t @ m i:
HYSTERIA	h I s t I@ r i: @
I	a: I
IE	a: I i:
ICE	a: I s
ICE-CREAM	a: I s k r i: m
ICEBERG	a: I s b @: g
ICICLE	a: I s I k @ l
ICING	a: I s I N
ID	a: I d i:
IDEA	a: I d I@
IDEAL	a: I d i: l
IDENTICAL	a: I d E n t I k @ l
IDENTIFICATION	a: I d E n t @ f @ k EI S @ n
IDENTIFY	a: I d E n t @ f a: I
IDENTITY	a: I d E n t @ t i:
IDIOM	I d i: @ m
IDIOT	I d i: @ t
IDLE	a: I d @ l
IDOL	a: I d @ l
IF	I f
IGNITE	I g n a: I t
IGNITION	I g n I S @ n
IGNORANT	I g n @ r @ n t
IGNORE	I g n o:
ILL	I l
ILLEGAL	I l i: g @ l
ILLEGIBLE	I l E dZ @ b @ l
ILLEGITIMATE	I l @ dZ I t @ m @ t
ILLICIT	I l I s @ t
ILLITERATE	I l I t @ r @ t
ILLUMINATE	I l u: m @ n EI t
ILLUSION	I l u: Z @ n
ILLUSTRATE	I l @ s t r EI t
IMAGE	I m I dZ
IMAGINARY	@ m A dZ @ n r i:
IMAGINARY	I m A dZ @ n @ r i:
IMAGINATION	I m A dZ @ n EI S @ n
IMAGINATION	@ m A dZ @ n EI S @ n
IMAGINE	I m A dZ @ n
IMAGINE	@ m A dZ @ n
IMAM	I m a: m
IMBECILE	I m b @ s i: l
IMITATE	I m @ t EI t
IMMACULATE	I m A k j u: l @ t
IMMACULATE	@ m A k j @ l @ t
IMMATURE	I m @ tS U@
IMMEDIATE	I m i: d i: @ t
IMMENSE	I m E n s
IMMERSE	I m @: s
IMMIGRANT	I m @ g r @ n t
IMMINENT	I m @ n @ n t
IMMORAL	I m O r @ l
IMMORTAL	I m o: t @ l
IMMUNE	I m j u: n
IMPACT	I m p A k t
IMPAIR	I m p E@
IMPARTIAL	I m p a: S @ l
IMPATIENT	I m p EI S @ n t
IMPEDE	I m p i: d
IMPERATIVE	I m p E r @ t I v
IMPERFECT	I m p @: f I k t
IMPERIAL	I m p I@ r i: @ l
IMPERSONAL	I m p @: s @ n @ l
IMPERSONATE	I m p @: s @ n EI t
IMPERTINENT	I m p @: t @ n @ n t
IMPETUOUS	I m p E t j u: @ s
IMPETUOUS	I m p E tS u: @ s
IMPLEMENT	I m p l @ m @ n t
IMPLICATE	I m p l @ k EI t
IMPLICATION	I m p l @ k EI S @ n
IMPLICIT	I m p l I s @ t
IMPLORE	I m p l o:
IMPLY	I m p l a: I
IMPOLITE	I m p @ l a: I t
IMPORT	I m p o: t
IMPORTANT	I m p o: t @ n t
IMPOSE	I m p @U z
IMPOSING	I m p @U z I N
IMPOSSIBLE	I m p O s @ b @ l
IMPOSTER	I m p O s t @
IMPOTENT	I m p @ t @ n t
IMPRESS	I m p r E s
IMPRESSION	I m p r E S @ n
IMPRISON	I m p r I z @ n
IMPROVE	I m p r u: v
IMPUDENT	I m p j u: d @ n t
IMPULSE	I m p a l s
IMPURE	I m p j U@
IN	I n
IN-	I n
IN-LAWS	I n l o: z
IN-PATIENT	I n p EI S @ n t
INACCURATE	I n A k j @ r @ t
INADEQUATE	I n A d @ k w @ t
INANE	I n EI n
INANIMATE	I n A n @ m @ t
INAPPROPRIATE	I n @ p r @U p r i: @ t
INCAPACITATE	I n k @ p A s @ t EI t
INCENTIVE	I n s E n t I v
INCESSANT	I n s E s @ n t
INCEST	I n s E s t
INCH	I n tS
INCIDENCE	I n s @ d @ n s
INCIDENT	I n s @ d @ n t
INCIDENTAL	I n s @ d E n t @ l
INCINERATE	I n s I n @ r EI t
INCITE	I n s a: I t
INCLINE	I N k l a: I n
INCLINED	I N k l a: I n d
INCLUDE	I N k l u: d
INCLUSIVE	I N k l u: s I v
INCOHERENT	I N k @U h I@ r @ n t
INCOME	I n k a m
INCOME	I N k a m
INCOMING	I N k a m I N
INCOMING	I n k a m I N
INCOMPETENT	I N k O m p @ t @ n t
INCONVENIENT	I N k @ n v i: n i: @ n t
INCORPORATE	I N k o: p @ r EI t
INCREASE	I N k r i: s
INCREDIBLE	I N k r E d @ b @ l
INCUR	I N k @:
INDEBTED	I n d E t @ d
INDECENT	I n d i: s @ n t
INDEED	I n d i: d
INDEFINITE	I n d E f @ n @ t
INDENT	I n d E n t
INDEPENDENT	I n d @ p E n d @ n t
INDEX	I n d E k s
INDICATE	I n d @ k EI t
INDICATOR	I n d @ k EI t @
INDIFFERENT	I n d I f r @ n t
INDIGENOUS	I n d I dZ @ n @ s
INDIGESTION	I n d @ dZ E s tS @ n
INDIGNANT	I n d I g n @ n t
INDISPENSABLE	I n d @ s p E n s @ b @ l
INDISPOSED	I n d @ s p @U z d
INDISPUTABLE	I n d @ s p j u: t @ b @ l
INDIVIDUAL	I n d @ v I dZ u: @ l
INDOCTRINATE	I n d O k t r @ n EI t
INDOLENT	I n d @ l @ n t
INDONESIAN	I n d @ n i: Z @ n
INDOORS	I n d o: z
INDUCE	I n d j u: s
INDULGE	I n d a l dZ
INDUSTRY	I n d @ s t r i:
INEPT	I n E p t
INEVITABLE	I n E v @ t @ b @ l
INEVITABLY	I n E v @ t @ b l i:
INEXPERIENCE	I n @ k s p I@ r i: @ n s
INFAMOUS	I n f @ m @ s
INFANT	I n f @ n t
INFATUATED	I n f A tS u: EI t @ d
INFECTION	I n f E k S @ n
INFECTIOUS	I n f E k S @ s
INFER	I n f @:
INFERIOR	I n f I@ r i: @
INFEST	I n f E s t
INFIDELITY	I n f @ d E l @ t i:
INFILTRATE	I n f @ l t r EI t
INFINITE	I n f @ n @ t
INFINITIVE	I n f I n @ t I v
INFLAME	I n f l EI m
INFLAMMABLE	I n f l A m @ b @ l
INFLATE	I n f l EI t
INFLATION	I n f l EI S @ n
INFLECT	I n f l E k t
INFLEXIBLE	I n f l E k s @ b @ l
INFLICT	I n f l I k t
INFLUENCE	I n f l u: @ n s
INFLUENZA	I n f l u: E n z @
INFLUX	I n f l a k s
INFORM	I n f o: m
INFORMAL	I n f o: m @ l
INFORMATION	I n f @ m EI S @ n
INFURIATE	I n f j u: r i: EI t
INGENIOUS	I n dZ i: n i: @ s
INGRAINED	I n g r EI n d
INGRATIATE	I n g r EI S i: EI t
INGRATITUDE	I n g r A t @ tS u: d
INGREDIENT	I n g r i: d i: @ n t
INHABIT	I n h A b @ t
INHALE	I n h EI l
INHERIT	I n h E r @ t
INITIAL	I n I S @ l
INITIATE	I n I S i: EI t
INITIATIVE	I n I S i: @ t I v
INITIATIVE	@ n I S @ t I v
INJECT	I n dZ E k t
INJURE	I n dZ @
INJUSTICE	I n dZ a s t @ s
INK	I N k
INKLING	I N k l I N
INLAID	I n l EI d
INLAND	I n l A n d
INMATE	I n m EI t
INNER	I n @
INNINGS	I n I N z
INNOCENT	I n @ s @ n t
INNUMERABLE	I n j u: m @ r @ b @ l
INOCULATE	I n O k j @ l EI t
INOCULATE	I n O k j u: l EI t
INQUEST	I N k w E s t
INQUIRE	I N k w a: I@
INQUISITIVE	I N k w I z @ t I v
INSANDOUTS	I n z @ n a: U t s
INSANE	I n s EI n
INSECT	I n s E k t
INSECTICIDE	I n s E k t @ s a: I d
INSECURE	I n s @ k j u: @
INSENSITIVE	I n s E n s @ t I v
INSERT	I n s @: t
INSIDE	I n s a: I d
INSINUATE	I n s I n j u: EI t
INSIPID	I n s I p @ d
INSIST	I n s I s t
INSOLENT	I n s @ l @ n t
INSPECT	I n s p E k t
INSPIRE	I n s p a: I@
INSTALL	I n s t o: l
INSTALMENT	I n s t o: l m @ n t
INSTANCE	I n s t @ n s
INSTANT	I n s t @ n t
INSTEAD	I n s t E d
INSTINCT	I n s t I N k t
INSTITUTE	I n s t @ tS u: t
INSTITUTION	I n s t @ t j u: S @ n
INSTRUCT	I n s t r a k t
INSTRUCTION	I n s t r a k S @ n
INSTRUMENT	I n s t r @ m @ n t
INSUBORDINATE	I n s @ b o: d @ n @ t
INSUBSTANTIAL	I n s @ b s t A n S @ l
INSUFFERABLE	I n s a f @ r @ b @ l
INSULATE	I n S @ l EI t
INSULIN	I n S @ l @ n
INSULT	I n s a l t
INSURE	I n S o:
INTACT	I n t A k t
INTEGRAL	I n t @ g r @ l
INTEGRATE	I n t @ g r EI t
INTEGRITY	I n t E g r @ t i:
INTELLECT	I n t @ l E k t
INTELLIGENCE	I n t E l @ dZ @ n s
INTELLIGENT	I n t E l @ dZ @ n t
INTEND	I n t E n d
INTENSE	I n t E n s
INTENSIVE	I n t E n s I v
INTENTION	I n t E n S @ n
INTERACT	I n t @ r A k t
INTERCEPT	I n t @ s E p t
INTERCOURSE	I n t @ k o: s
INTEREST	I n t r @ s t
INTERESTING	I n t r @ s t I N
INTERFERE	I n t @ f I@
INTERIM	I n t @ r @ m
INTERIOR	I n t I@ r i: @
INTERJECTION	I n t @ dZ E k S @ n
INTERLUDE	I n t @ l u: d
INTERMEDIATE	I n t @ m i: d i: @ t
INTERMISSION	I n t @ m I S @ n
INTERMITTENT	I n t @ m I t @ n t
INTERNAL	I n t @: n @ l
INTERNATIONAL	I n t @ n A S @ n @ l
INTERPRET	I n t @: p r @ t
INTERROGATE	I n t E r @ g EI t
INTERROGATIVE	I n t @ r O g @ t I v
INTERRUPT	I n t @ r a p t
INTERSECTION	I n t @ s E k S @ n
INTERSTATE	I n t @ s t EI t
INTERVAL	I n t @ v @ l
INTERVENE	I n t @ v i: n
INTERVIEW	I n t @ v j u:
INTESTINE	I n t E s t @ n
INTIMATE	I n t @ m @ t
INTIMIDATE	I n t I m @ d EI t
INTO	I n t u:
INTONATION	I n t @ n EI S @ n
INTOXICATED	I n t O k s @ k EI t @ d
INTRANSITIVE	I n t r A n z @ t I v
INTRAVENOUS	I n t r @ v i: n @ s
INTRIGUE	I n t r i: g
INTRODUCE	I n t r @ d j u: s
INTRODUCTION	I n t r @ d a k S @ n
INTRUDE	I n t r u: d
INTUITION	I n tS u: I S @ n
INVADE	I n v EI d
INVALID	I n v @ l I d
INVALID	I n v A l @ d
INVALIDPENSION	I n v @ l I d p E n S @ n
INVALUABLE	I n v A l j @ b @ l
INVENT	I n v E n t
INVERTEDCOMMA	I n v @: t @ d k O m @
INVEST	I n v E s t
INVESTIGATE	I n v E s t @ g EI t
INVIGORATE	I n v I g @ r EI t
INVISIBLE	I n v I z @ b @ l
INVITE	I n v a: I t
INVOICE	I n v o: I s
INVOLVE	I n v O l v
INVOLVED	I n v O l v d
IOU	a: I@ U j u:
IRATE	a: I r EI t
IRIS	a: I r @ s
IRK	@: k
IRON	a: I@ n
IRONY	a: I r @ n i:
IRRATIONAL	I r A S @ n @ l
IRREGULAR	I r E g j @ l @
IRRELEVANT	I r E l @ v @ n t
IRRIGATE	I r @ g EI t
IRRITATE	I r @ t EI t
IS	I z
ISLAM	I z l A m
ISLAND	a: I l @ n d
ISOLATE	a: I s @ l EI t
ISSUE	I S u:
IT	I t
ITALIAN	I t A l j @ n
ITALICS	I t A l I k s
ITCH	I tS
ITEM	a: I t @ m
ITINERARY	a: I t I n @ r i:
ITS	I t s
ITSELF	I t s E l f
IVE	a: I v
IVY	a: I v i:
J	dZ EI
JAB	dZ A b
JABBER	dZ A b @
JABIRU	dZ A b @ r u:
JACK	dZ A k
JACKEROO	dZ A k @ r u:
JACKET	dZ A k @ t
JACKKNIFE	dZ A k n a: I f
JACKPOT	dZ A k p O t
JADE	dZ EI d
JADED	dZ EI d @ d
JAGGED	dZ A g @ d
JAIL	dZ EI l
JAM	dZ A m
JAMB	dZ A m
JAN	dZ A n j u: @ r i:
JANGLE	dZ A N g @ l
JANUARY	dZ A n j u: @ r i:
JAPANESE	dZ A p @ n i: z
JAR	dZ a:
JARGON	dZ a: g @ n
JARRAH	dZ A r @
JAUNDICE	dZ o: n d @ s
JAUNT	dZ o: n t
JAUNTY	dZ o: n t i:
JAVELIN	dZ A v @ l @ n
JAW	dZ o:
JAYWALK	dZ EI w o: k
JAZZ	dZ A z
JEALOUS	dZ E l @ s
JEANS	dZ i: n z
JEEP	dZ i: p
JEER	dZ I@
JELLY	dZ E l i:
JELLYFISH	dZ E l i: f I S
JEOPARDY	dZ E p @ d i:
JERK	dZ @: k
JERSEY	dZ @: z i:
JET	dZ E t
JETTISON	dZ E t @ s @ n
JETTY	dZ E t i:
JEWEL	dZ u: @ l
JEWELLERY	dZ u: @ l r i:
JEWISH	dZ u: I S
JIBE	dZ a: I b
JIFFY	dZ I f i:
JIG	dZ I g
JIGGLE	dZ I g @ l
JIGSAW	dZ I g s o:
JILLAROO	dZ I l @ r u:
JILT	dZ I l t
JINGLE	dZ I N g @ l
JINX	dZ I N k s
JITTERS	dZ I t @ z
JIVE	dZ a: I v
JNR	dZ u: n j @
JOB	dZ O b
JOBLESS	dZ O b l @ s
JOCKEY	dZ O k i:
JOCULAR	dZ O k j @ l @
JODHPURS	dZ O d p @ z
JOEY	dZ @U i:
JOG	dZ O g
JOIN	dZ o: I n
JOINER	dZ o: I n @
JOINT	dZ o: I n t
JOIST	dZ o: I s t
JOKE	dZ @U k
JOKER	dZ @U k @
JOLLY	dZ O l i:
JOLT	dZ @U l t
JOSTLE	dZ O s @ l
JOT	dZ O t
JOTTER	dZ O t @
JOULE	dZ u: l
JOURNAL	dZ @: n @ l
JOURNALIST	dZ @: n @ l @ s t
JOURNEY	dZ @: n i:
JOVIAL	dZ @U v i: @ l
JOY	dZ o: I
JP	dZ EI p i:
JUBE	dZ u: b
JUBILANT	dZ u: b @ l @ n t
JUBILEE	dZ u: b @ l i:
JUDAISM	dZ u: d EI I z @ m
JUDGE	dZ a dZ
JUDGMENT	dZ a dZ m @ n t
JUDICIAL	dZ u: d I S @ l
JUDICIOUS	dZ u: d I S @ s
JUDO	dZ u: d @U
JUG	dZ a g
JUGGLE	dZ a g @ l
JUICE	dZ u: s
JUKEBOX	dZ u: k b O k s
JUL	dZ @ l a: I
JULY	dZ @ l a: I
JUMBLE	dZ a m b @ l
JUMBO	dZ a m b @U
JUMBUCK	dZ a m b a k
JUMP	dZ a m p
JUMPER	dZ a m p @
JUMPY	dZ a m p i:
JUN	dZ u: n
JUNCTION	dZ a N k S @ n
JUNCTURE	dZ a N k tS @
JUNE	dZ u: n
JUNGLE	dZ a N g @ l
JUNIOR	dZ u: n j @
JUNK	dZ a N k
JUNKIE	dZ a N k i:
JUNTA	dZ a n t @
JURISDICTION	dZ u: r @ s d I k S @ n
JURY	dZ u: r i:
JUST	dZ a s t
JUSTICE	dZ a s t @ s
JUSTICEOFTHEPEACE	dZ a s t @ s @ v D @ p i: s
JUSTIFY	dZ a s t @ f a: I
JUT	dZ a t
JUTE	dZ u: t
JUVENILE	dZ u: v @ n a: I l
JUXTAPOSE	dZ a k s t @ p @U z
K	k EI
KALEIDOSCOPE	k @ l a: I d @ s k @U p
KANGAROO	k A N g @ r u:
KARATE	k @ r a: t i:
KAYAK	k a: I A k
KEBAB	k @ b A b
KEEL	k i: l
KEEN	k i: n
KEEP	k i: p
KEEPER	k i: p @
KEEPING	k i: p I N
KEEPSAKE	k i: p s EI k
KEG	k E g
KELP	k E l p
KENNEL	k E n @ l
KEPT	k E p t
KERB	k @: b
KERNEL	k @: n @ l
KERO	k E r @U
KEROSENE	k E r @ s i: n
KETCHUP	k E tS @ p
KETTLE	k E t @ l
KEY	k i:
KEYBOARD	k i: b o: d
KEYNOTE	k i: n @U t
KG	k EI dZ i:
KHAKI	k a: k i:
KHMER	k @ m E@
KIBBLE	k I b @ l
KICK	k I k
KID	k I d
KIDNAP	k I d n A p
KIDNEY	k I d n i:
KILL	k I l
KILLING	k I l I N
KILN	k I l n
KILO	k i: l @U
KILOBYTE	k I l @ b a: I t
KILOGRAM	k I l @ g r A m
KILOHERTZ	k I l @ h @: t s
KILOJOULE	k I l @ dZ u: l
KILOMETRE	k @ l O m @ t @
KILOMETRE	k I l @ m i: t @
KILOWATT	k I l @ w O t
KILT	k I l t
KIMONO	k I m @ n @U
KIMONO	k @ m @U n @U
KIN	k I n
KIND	k a: I n d
KINDERGARTEN	k I n d @ g a: t @ n
KINDLE	k I n d @ l
KINDLING	k I n d l I N
KINDLY	k a: I n d l i:
KINDRED	k I n d r @ d
KINDY	k I n d i:
KING	k I N
KINGDOM	k I N d @ m
KINK	k I N k
KINSHIP	k I n S I p
KIOSK	k i: O s k
KISS	k I s
KIT	k I t
KITCHEN	k I tS @ n
KITCHENTEA	k I tS @ n t i:
KITCHENETTE	k I tS @ n E t
KITE	k a: I t
KITSCH	k I tS
KITTEN	k I t @ n
KIWI	k i: w i:
KJ	k I l @ dZ u: l
KLEPTOMANIA	k l E p t @ m EI n i: @
KM	k @ l O m @ t @
KM	k I l @ m i: t @
KNACK	n A k
KNACKERED	n A k @ d
KNAPSACK	n A p s A k
KNAVE	n EI v
KNEAD	n i: d
KNEE	n i:
KNEECAP	n i: k A p
KNEEL	n i: l
KNEW	n j u:
KNICK-KNACK	n I k n A k
KNICKERS	n I k @ z
KNIFE	n a: I f
KNIGHT	n a: I t
KNIT	n I t
KNITTING	n I t I N
KNOB	n O b
KNOCK	n O k
KNOT	n O t
KNOW	n @U
KNOWING	n @U I N
KNOWLEDGE	n O l I dZ
KNOWN	n @U n
KNUCKLE	n a k @ l
KO	k EI @U
KOALA	k @U a: l @
KOOKABURRA	k U k @ b a r @
KOREAN	k @ r i: @ n
KOSHER	k @U S @
KUNG-FU	k a N f u:
L	E l
L-PLATE	E l p l EI t
LA	l a:
LA	l EI n
LABEL	l EI b @ l
LABOR	l EI b @
LABORPARTY	l EI b @ p a: t i:
LABORATORY	l @ b O r @ t r i:
LABOUR	l EI b @
LACE	l EI s
LACERATE	l A s @ r EI t
LACK	l A k
LACQUER	l A k @
LAD	l A d
LADDER	l A d @
LADY	l EI d i:
LAG	l A g
LAGER	l a: g @
LAGOON	l @ g u: n
LAID	l EI d
LAKE	l EI k
LAMB	l A m
LAME	l EI m
LAMINATE	l A m @ n EI t
LAMINGTON	l A m I N t @ n
LAND	l A n d
LANDLADY	l A n d l EI d i:
LANDLORD	l A n d l o: d
LANDMARK	l A n d m a: k
LANDSCAPE	l A n d s k EI p
LANDSLIDE	l A n d s l a: I d
LANE	l EI n
LANGUAGE	l A N g w I dZ
LANGUAGE	l A N w I dZ
LANK	l A N k
LANKY	l A N k i:
LANTERN	l A n t @ n
LAO	l a: U
LAP	l A p
LAPSE	l A p s
LARGE	l a: dZ
LARRIKIN	l A r @ k @ n
LARYNGITIS	l A r @ n dZ a: I t @ s
LARYNX	l A r I N k s
LASER	l EI z @
LASH	l A S
LAST	l a: s t
LATCH	l A tS
LATE	l EI t
LATELY	l EI t l i:
LATER	l EI t @
LATEST	l EI t @ s t
LATHER	l A D @
LATIN	l A t @ n
LATITUDE	l A t @ tS u: d
LATTER	l A t @
LATTICE	l A t @ s
LAUGH	l a: f
LAUNCH	l o: n tS
LAUNDROMAT	l o: n d r @ m A t
LAUNDRY	l o: n d r i:
LAVATORY	l A v @ t r i:
LAVENDER	l A v @ n d @
LAVISH	l A v I S
LAW	l o:
LAWFUL	l o: f @ l
LAWN	l o: n
LAWNMOWER	l o: n m @U @
LAWYER	l o: I@
LAX	l A k s
LAXATIVE	l A k s @ t I v
LAY	l EI
LAY-BY	l EI b a: I
LAYER	l EI @
LAYOUT	l EI a: U t
LAZY	l EI z i:
LEAD	l i: d
LEAD	l E d
LEADER	l i: d @
LEAF	l i: f
LEAGUE	l i: g
LEAK	l i: k
LEAN	l i: n
LEANT	l E n t
LEAP	l i: p
LEAPT	l E p t
LEARN	l @: n
LEASE	l i: s
LEASH	l i: S
LEAST	l i: s t
LEATHER	l E D @
LEAVE	l i: v
LECTURE	l E k tS @
LED	l E d
LEDGE	l E dZ
LEDGER	l E dZ @
LEER	l I@
LEFT	l E f t
LEFT-HANDED	l E f t h A n d @ d
LEG	l E g
LEGAL	l i: g @ l
LEGEND	l E dZ @ n d
LEGGINGS	l E g I N z
LEGIBLE	l E dZ @ b @ l
LEGISLATION	l E dZ @ s l EI S @ n
LEGITIMATE	l @ dZ I t @ m @ t
LEISURE	l E Z @
LEMON	l E m @ n
LEMONADE	l E m @ n EI d
LEND	l E n d
LENGTH	l E N k T
LENGTH	l E N T
LENGTHEN	l E N T @ n
LENGTHEN	l E N k T @ n
LENIENT	l i: n i: @ n t
LENS	l E n z
LENT	l E n t
LEOTARD	l i: @ t a: d
LESBIAN	l E z b i: @ n
LESS	l E s
LESSEN	l E s @ n
LESSON	l E s @ n
LET	l E t
LETHAL	l i: T @ l
LETTER	l E t @
LEUKAEMIA	l u: k i: m i: @
LEVEL	l E v @ l
LEVER	l i: v @
LEVY	l E v i:
LIABILITY	l a: I@ b I l @ t i:
LIABLE	l a: I@ b @ l
LIAISON	l i: EI z @ n
LIAISON	l i: EI z O n
LIAR	l a: I@
LIBEL	l a: I b @ l
LIBERAL	l I b r @ l
LIBERALPARTYOFAUSTRALIA	l I b r @ l p a: t i: @ v O s t r EI l j @
LIBERATE	l I b @ r EI t
LIBERTY	l I b @ t i:
LIBRARY	l a: I b r i:
LICE	l a: I s
LICENCE	l a: I s @ n s
LICK	l I k
LICORICE	l I k @ r I S
LID	l I d
LIE	l a: I
LIFE	l a: I f
LIFELONG	l a: I f l O N
LIFESAVER	l a: I f s EI v @
LIFETIME	l a: I f t a: I m
LIFT	l I f t
LIGHT	l a: I t
LIGHTNING	l a: I t n I N
LIKE	l a: I k
LIKELY	l a: I k l i:
LIMB	l I m
LIME	l a: I m
LIMELIGHT	l a: I m l a: I t
LIMESTONE	l a: I m s t @U n
LIMIT	l I m @ t
LIMITEDCOMPANY	l I m @ t @ d k a m p @ n i:
LIMP	l I m p
LINE	l a: I n
LINEN	l I n @ n
LINER	l a: I n @
LINGER	l I N g @
LINGERIE	l O n Z @ r EI
LINGUISTIC	l I N g w I s t I k
LINIMENT	l I n @ m @ n t
LINING	l a: I n I N
LINK	l I N k
LINOLEUM	l @ n @U l i: @ m
LINSEEDOIL	l I n s i: d o: I l
LIP	l I p
LIPSTICK	l I p s t I k
LIQUEFY	l I k w @ f a: I
LIQUEUR	l @ k j u: @
LIQUID	l I k w @ d
LIQUIDATE	l I k w @ d EI t
LIQUOR	l I k @
LISP	l I s p
LIST	l I s t
LISTEN	l I s @ n
LISTLESS	l I s t l @ s
LIT	l I t
LITERAL	l I t r @ l
LITERARY	l I t @ r @ r i:
LITERATE	l I t @ r @ t
LITERATURE	l I t r @ tS @
LITRE	l i: t @
LITTER	l I t @
LITTERBUG	l I t @ b a g
LITTLE	l I t @ l
LIVE	l I v
LIVELIHOOD	l a: I v l i: h U d
LIVELY	l a: I v l i:
LIVER	l I v @
LIVESTOCK	l a: I v s t O k
LIVID	l I v @ d
LIVING	l I v I N
LIZARD	l I z @ d
LOAD	l @U d
LOAF	l @U f
LOAM	l @U m
LOAN	l @U n
LOATH	l @U T
LOATHE	l @U D
LOB	l O b
LOBBY	l O b i:
LOCAL	l @U k @ l
LOCATE	l @U k EI t
LOCK	l O k
LOCKER	l O k @
LOCKET	l O k @ t
LOCKSMITH	l O k s m I T
LOCOMOTIVE	l @U k @ m @U t I v
LODGE	l O dZ
LOFT	l O f t
LOFTY	l O f t i:
LOG	l O g
LOGICAL	l O dZ I k @ l
LOITER	l o: I t @
LOLLY	l O l i:
LONE	l @U n
LONELY	l @U n l i:
LONG	l O N
LONGITUDE	l O N g @ tS u: d
LOOK	l U k
LOOKOUT	l U k a: U t
LOOM	l u: m
LOOP	l u: p
LOOPHOLE	l u: p h @U l
LOOSE	l u: s
LOOT	l u: t
LOP	l O p
LOPSIDED	l O p s a: I d @ d
LORD	l o: d
LORRY	l O r i:
LOSE	l u: z
LOSS	l O s
LOST	l O s t
LOT	l O t
LOTION	l @U S @ n
LOTTERY	l O t @ r i:
LOTTO	l O t @U
LOUD	l a: U d
LOUDSPEAKER	l a: U d s p i: k @
LOUNGE	l a: U n dZ
LOUSE	l a: U s
LOUSY	l a: U z i:
LOUT	l a: U t
LOVE	l a v
LOVELY	l a v l i:
LOW	l @U
LOWER	l @U @
LOYAL	l o: I@ l
LOZENGE	l O z @ n dZ
LPG	E l p i: dZ i:
LTD	l I m @ t @ d
LUBRICATE	l u: b r @ k EI t
LUCID	l u: s @ d
LUCK	l a k
LUCRATIVE	l u: k r @ t I v
LUDICROUS	l u: d @ k r @ s
LUG	l a g
LUGGAGE	l a g I dZ
LUKEWARM	l u: k w o: m
LULL	l a l
LULLABY	l a l @ b a: I
LUMINOUS	l u: m @ n @ s
LUMP	l a m p
LUNAR	l u: n @
LUNATIC	l u: n @ t I k
LUNCH	l a n tS
LUNG	l a N
LUNGE	l a n dZ
LURCH	l @: tS
LURGY	l @: g i:
LURID	l u: r @ d
LURK	l @: k
LUSCIOUS	l a S @ s
LUSH	l a S
LUST	l a s t
LUXURIANT	l a g Z u: r i: @ n t
LUXURY	l a k S @ r i:
LYING	l a: I I N
LYREBIRD	l a: I@ b @: d
M	E m
MACABRE	m @ k a: b
MACADAMIA	m A k @ d EI m i: @
MACARONI	m A k @ r @U n i:
MACEDONIAN	m A s @ d @U n i: @ n
MACHETE	m @ S E t i:
MACHINE	m @ S i: n
MACHINERY	m @ S i: n r i:
MACHINERY	m @ S i: n @ r i:
MACHO	m A tS @U
MAD	m A d
MADAM	m A d @ m
MADE	m EI d
MAGAZINE	m A g @ z i: n
MAGGOT	m A g @ t
MAGIC	m A dZ I k
MAGISTRATE	m A dZ @ s t r EI t
MAGNANIMOUS	m A g n A n @ m @ s
MAGNATE	m A g n EI t
MAGNET	m A g n @ t
MAGNIFICENT	m A g n I f @ s @ n t
MAGNIFY	m A g n @ f a: I
MAGNIFYINGGLASS	m A g n @ f a: I I N g l a: s
MAGNITUDE	m A g n @ tS u: d
MAGPIE	m A g p a: I
MAIDEN	m EI d @ n
MAIL	m EI l
MAILORDER	m EI l o: d @
MAIM	m EI m
MAIN	m EI n
MAINLAND	m EI n l A n d
MAINSTREAM	m EI n s t r i: m
MAINTAIN	m EI n t EI n
MAITREDHOTEL	m EI t r @ d @U t E l
MAIZE	m EI z
MAJESTY	m A dZ @ s t i:
MAJOR	m EI dZ @
MAJORITY	m @ dZ O r @ t i:
MAKE	m EI k
MAKE-BELIEVE	m EI k b @ l i: v
MAKE-UP	m EI k a p
MALADJUSTED	m A l @ dZ a s t @ d
MALARIA	m @ l E@ r i: @
MALE	m EI l
MALEVOLENT	m @ l E v @ l @ n t
MALFORMATION	m A l f o: m EI S @ n
MALICE	m A l @ s
MALIGN	m @ l a: I n
MALIGNANT	m @ l I g n @ n t
MALINGER	m @ l I N g @
MALL	m o: l
MALLEABLE	m A l i: @ b @ l
MALLEE	m A l i:
MALLET	m A l @ t
MALNOURISHED	m A l n a r I S t
MALPRACTICE	m A l p r A k t @ s
MALT	m O l t
MALTREAT	m A l t r i: t
MAMMAL	m A m @ l
MAMMOTH	m A m @ T
MAN	m A n
MANAGE	m A n I dZ
MANAGEMENT	m A n I dZ m @ n t
MANAGER	m A n @ dZ @
MANCHESTER	m A n tS E s t @
MANDARIN	m A n d @ r I n
MANDARIN	m A n d @ r @ n
MANDATE	m A n d EI t
MANDATORY	m A n d @ t r i:
MANE	m EI n
MANGE	m EI n dZ
MANGLE	m A N g @ l
MANGROVE	m A N g r @U v
MANIA	m EI n i: @
MANIAC	m EI n i: A k
MANICURE	m A n @ k j U@
MANIFEST	m A n @ f E s t
MANIFESTO	m A n @ f E s t @U
MANIPULATE	m @ n I p j @ l EI t
MANKIND	m A n k a: I n d
MANLY	m A n l i:
MANNER	m A n @
MANNERISM	m A n @ r I z @ m
MANOEUVRE	m @ n u: v @
MANOR	m A n @
MANSION	m A n S @ n
MANSLAUGHTER	m A n s l o: t @
MANTA	m A n t @
MANTLEPIECE	m A n t @ l p i: s
MANUAL	m A n j u: @ l
MANUFACTURE	m A n j @ f A k tS @
MANURE	m @ n j U@
MANUSCRIPT	m A n j @ s k r I p t
MANY	m E n i:
MAP	m A p
MARATHON	m A r @ T O n
MARBLE	m a: b @ l
MARCH	m a: tS
MARE	m E@
MARGARINE	m a: dZ @ r i: n
MARGIN	m a: dZ @ n
MARGINAL	m a: dZ @ n @ l
MARIJUANA	m A r @ w a: n @
MARINA	m @ r i: n @
MARINATE	m A r @ n EI t
MARINE	m @ r i: n
MARITAL	m A r @ t @ l
MARITIME	m A r @ t a: I m
MARK	m a: k
MARK-UP	m a: k a p
MARKET	m a: k @ t
MARKETING	m a: k @ t I N
MARMALADE	m a: m @ l EI d
MAROON	m @ r u: n
MARQUEE	m a: k i:
MARRIAGE	m A r I dZ
MARRIED	m A r i: d
MARROW	m A r @U
MARRY	m A r i:
MARSH	m a: S
MARSHAL	m a: S @ l
MARSHMALLOW	m a: S m A l @U
MARSUPIAL	m a: s j u: p i: @ l
MARTYR	m a: t @
MARVEL	m a: v @ l
MASCARA	m A s k a: r @
MASCOT	m A s k O t
MASCULINE	m A s k j @ l @ n
MASH	m A S
MASK	m a: s k
MASON	m EI s @ n
MASONRY	m EI s @ n r i:
MASQUERADE	m A s k @ r EI d
MASS	m A s
MASSACRE	m A s @ k @
MASSAGE	m A s a: Z
MASSIVE	m A s I v
MAST	m a: s t
MASTECTOMY	m A s t E k t @ m i:
MASTER	m a: s t @
MASTERPIECE	m a: s t @ p i: s
MASTURBATE	m A s t @ b EI t
MAT	m A t
MATCH	m A tS
MATE	m EI t
MATERIAL	m @ t I@ r i: @ l
MATERIALISE	m @ t I@ r i: @ l a: I z
MATERIALISTIC	m @ t I@ r i: @ l I s t I k
MATERNAL	m @ t @: n @ l
MATERNITY	m @ t @: n @ t i:
MATHEMATICS	m A T @ m A t I k s
MATHS	m A T s
MATRIARCH	m EI t r i: a: k
MATRIMONY	m A t r @ m @ n i:
MATT	m A t
MATTER	m A t @
MATTRESS	m A t r @ s
MATURE	m @ tS u: @
MATURE	m @ tS U@
MAUL	m o: l
MAUVE	m @U v
MAVERICK	m A v @ r I k
MAXIM	m A k s @ m
MAXIMUM	m A k s @ m @ m
MAY	m EI
MAYBE	m EI b i:
MAYONNAISE	m EI @ n EI z
MAYOR	m E@
MAZE	m EI z
ME	m i:
MEAGRE	m i: g @
MEAL	m i: l
MEAN	m i: n
MEANDER	m i: A n d @
MEANS	m i: n z
MEANTIME	m i: n t a: I m
MEANWHILE	m i: n w a: I l
MEASLES	m i: z @ l z
MEASURE	m E Z @
MEAT	m i: t
MECHANIC	m @ k A n I k
MECHANICAL	m @ k A n I k @ l
MECHANICS	m @ k A n I k s
MECHANISE	m E k @ n a: I z
MECHANISM	m E k @ n I z @ m
MEDAL	m E d @ l
MEDALLION	m @ d A l j @ n
MEDDLE	m E d @ l
MEDIA	m i: d i: @
MEDIAN	m i: d i: @ n
MEDIATE	m i: d i: EI t
MEDICAL	m E d I k @ l
MEDICARE	m E d i: k E@
MEDICINE	m E d @ s @ n
MEDIOCRE	m i: d i: @U k @
MEDITATE	m E d @ t EI t
MEDIUM	m i: d i: @ m
MEDLEY	m E d l i:
MEEK	m i: k
MEET	m i: t
MEETING	m i: t I N
MEGABYTE	m E g @ b a: I t
MEGAPHONE	m E g @ f @U n
MELANCHOLY	m E l @ n k O l i:
MELANOMA	m E l @ n @U m @
MELBA	m E l b @
MELLOW	m E l @U
MELODRAMA	m E l @ d r a: m @
MELODY	m E l @ d i:
MELON	m E l @ n
MELT	m E l t
MEMBER	m E m b @
MEMBRANE	m E m b r EI n
MEMENTO	m @ m E n t @U
MEMO	m E m @U
MEMOIRS	m E m w a: z
MEMORABLE	m E m r @ b @ l
MEMORIAL	m @ m o: r i: @ l
MEMORISE	m E m @ r a: I z
MEMORY	m E m @ r i:
MEN	m E n
MENACE	m E n @ s
MEND	m E n d
MENIAL	m i: n i: @ l
MENOPAUSE	m E n @ p o: z
MENSTRUATE	m E n s t r u: EI t
MENTAL	m E n t @ l
MENTION	m E n S @ n
MENU	m E n j u:
MERCENARY	m @: s @ n r i:
MERCHANDISE	m @: tS @ n d a: I s
MERCURY	m @: k j @ r i:
MERCY	m @: s i:
MERE	m I@
MERGE	m @: dZ
MERINGUE	m @ r A N
MERINO	m @ r i: n @U
MERIT	m E r @ t
MERMAID	m @: m EI d
MERRY	m E r i:
MERRY-GO-ROUND	m E r i: g @U r a: U n d
MESH	m E S
MESMERISE	m E z m @ r a: I z
MESS	m E s
MESSAGE	m E s I dZ
MESSENGER	m E s @ n dZ @
METABOLISM	m @ t A b @ l I z @ m
METAL	m E t @ l
METAMORPHOSIS	m E t @ m o: f @ s @ s
METAPHOR	m E t @ f o:
METEOR	m i: t i: o:
METEORITE	m i: t i: @ r a: I t
METEOROLOGIST	m i: t i: @ r O l @ dZ @ s t
METER	m i: t @
METHADONE	m E T @ d @U n
METHO	m E T @U
METHOD	m E T @ d
METHODICAL	m @ T O d I k @ l
METHYLATEDSPIRITS	m E T @ l EI t @ d s p I r @ t s
METICULOUS	m @ t I k j @ l @ s
METRE	m i: t @
METRIC	m E t r I k
METROPOLITAN	m E t r @ p O l @ t @ n
MEZZANINE	m E z @ n i: n
MICE	m a: I s
MICROBE	m a: I k r @U b
MICROPHONE	m a: I k r @ f @U n
MICROSCOPE	m a: I k r @ s k @U p
MICROWAVEOVEN	m a: I k r @ w EI v a v @ n
MID	m I d
MIDDAY	m I d d EI
MIDDLE	m I d @ l
MIDGET	m I dZ @ t
MIDNIGHT	m I d n a: I t
MIDRIFF	m I d r I f
MIDWIFE	m I d w a: I f
MIGHT	m a: I t
MIGHTY	m a: I t i:
MIGRAINE	m a: I g r EI n
MIGRANT	m a: I g r @ n t
MIGRATE	m a: I g r EI t
MILD	m a: I l d
MILDEW	m I l d j u:
MILE	m a: I l
MILITANT	m I l @ t @ n t
MILITARY	m I l @ t r i:
MILITIA	m @ l I S @
MILK	m I l k
MILKBAR	m I l k b a:
MILKSHAKE	m I l k S EI k
MILL	m I l
MILLENNIUM	m @ l E n i: @ m
MILLIBAR	m I l i: b a:
MILLIGRAM	m I l @ g r A m
MILLILITRE	m I l @ l i: t @
MILLIMETRE	m I l @ m i: t @
MILLINER	m I l @ n @
MILLION	m I l j @ n
MIME	m a: I m
MIMIC	m I m I k
MINCE	m I n s
MINCEMEAT	m I n s m i: t
MIND	m a: I n d
MINDFUL	m a: I n d f @ l
MINDLESS	m a: I n d l @ s
MINE	m a: I n
MINER	m a: I n @
MINERAL	m I n @ r @ l
MINERALWATER	m I n @ r @ l w o: t @
MINGLE	m I N g @ l
MINIATURE	m I n @ tS @
MINIMAL	m I n @ m @ l
MINIMUM	m I n @ m @ m
MINISTER	m I n @ s t @
MINOR	m a: I n @
MINORITY	m a: I n O r @ t i:
MINT	m I n t
MINUS	m a: I n @ s
MINUTE	m a: I n j u: t
MIRACLE	m I r @ k @ l
MIRAGE	m @ r a: Z
MIRE	m a: I@
MIRROR	m I r @
MIRTH	m @: T
MISADVENTURE	m I s @ d v E n tS @
MISBEHAVE	m I s b @ h EI v
MISCARRIAGE	m I s k A r I dZ
MISCELLANEOUS	m I s @ l EI n i: @ s
MISCHIEF	m I s tS @ f
MISDEMEANOUR	m I s d @ m i: n @
MISER	m a: I z @
MISERABLE	m I z r @ b @ l
MISERY	m I z @ r i:
MISFORTUNE	m I s f o: tS @ n
MISHAP	m I s h A p
MISLAY	m I s l EI
MISLEAD	m I s l i: d
MISS	m I s
MISSILE	m I s a: I l
MISSING	m I s I N
MISSION	m I S @ n
MISSIONARY	m I S @ n r i:
MIST	m I s t
MISTAKE	m @ s t EI k
MISTAKEN	m @ s t EI k @ n
MISTRESS	m I s t r @ s
MISUNDERSTAND	m I s a n d @ s t A n d
MITIGATE	m I t @ g EI t
MITTEN	m I t @ n
MIX	m I k s
MIX-UP	m I k s a p
MIXED-UP	m I k s t a p
MIXTURE	m I k s tS @
MNEMONIC	n @ m O n I k
MOAN	m @U n
MOB	m O b
MOBILE	m @U b a: I l
MOBILISE	m @U b @ l a: I z
MOCK	m O k
MODAL	m @U d @ l
MODE	m @U d
MODEL	m O d @ l
MODERATE	m O d r @ t
MODERN	m O d @ n
MODEST	m O d @ s t
MODIFY	m O d @ f a: I
MODULE	m O dZ u: l
MOIST	m o: I s t
MOLAR	m @U l @
MOLE	m @U l
MOLECULE	m O l @ k j u: l
MOLEST	m @ l E s t
MOLTEN	m @U l t @ n
MOMENT	m @U m @ n t
MOMENTARY	m @U m @ n t r i:
MOMENTOUS	m @ m E n t @ s
MONARCH	m O n a: k
MONARCH	m O n @ k
MONASTERY	m O n @ s t r i:
MONDAY	m a n d EI
MONEY	m a n i:
MONGREL	m a N g r @ l
MONITOR	m O n @ t @
MONK	m a N k
MONKEY	m a N k i:
MONO	m O n @U
MONOGAMY	m @ n O g @ m i:
MONOGRAM	m O n @ g r A m
MONOLITH	m O n @ l I T
MONOLOGUE	m O n @ l O g
MONOPOLY	m @ n O p @ l i:
MONOSODIUMGLUTAMATE	m O n @ s @U d i: @ m g l u: t @ m EI t
MONOTONOUS	m @ n O t @ n @ s
MONOTREME	m O n @ t r i: m
MONSOON	m O n s u: n
MONSTER	m O n s t @
MONSTROUS	m O n s t r @ s
MONTH	m a n T
MONUMENT	m O n j @ m @ n t
MONUMENTAL	m O n j @ m E n t @ l
MOOD	m u: d
MOODY	m u: d i:
MOON	m u: n
MOOR	m o:
MOORING	m o: r I N
MOP	m O p
MOPE	m @U p
MORAL	m O r @ l
MORALE	m @ r a: l
MORATORIUM	m O r @ t o: r i: @ m
MORBID	m o: b @ d
MORE	m o:
MOREOVER	m o: r @U v @
MORGUE	m o: g
MORNAY	m o: n EI
MORNING	m o: n I N
MORON	m o: r O n
MOROSE	m @ r @U s
MORPHINE	m o: f i: n
MORSEL	m o: s @ l
MORTAL	m o: t @ l
MORTALITY	m o: t A l @ t i:
MORTAR	m o: t @
MORTGAGE	m o: g I dZ
MORTIFIED	m o: t @ f a: I d
MORTUARY	m o: tS @ r i:
MOSAIC	m @U z EI I k
MOSAIC	m @ z EI I k
MOSQUE	m O s k
MOSS	m O s
MOST	m @U s t
MOSTLY	m @U s t l i:
MOTEL	m @U t E l
MOTHER	m a D @
MOTHER-IN-LAW	m a D @ r I n l o:
MOTHER-OF-PEARL	m a D @ r @ v p @: l
MOTIF	m @U t i: f
MOTION	m @U S @ n
MOTIVATE	m @U t @ v EI t
MOTIVE	m @U t I v
MOTOR	m @U t @
MOTORBIKE	m @U t @ b a: I k
MOTORCYCLE	m @U t @ s a: I k @ l
MOTORIST	m @U t @ r @ s t
MOTTLED	m O t @ l d
MOTTO	m O t @U
MOULD	m @U l d
MOULT	m @U l t
MOUND	m a: U n d
MOUNT	m a: U n t
MOUNTAIN	m a: U n t @ n
MOUNTAINEER	m a: U n t @ n I@
MOURN	m o: n
MOUSE	m a: U s
MOUSSE	m u: s
MOUSTACHE	m @ s t a: S
MOUSY	m a: U s i:
MOUTH	m a: U T
MOUTH-WATERING	m a: U T w o: t @ r I N
MOVE	m u: v
MOVEMENT	m u: v m @ n t
MOVIE	m u: v i:
MOW	m @U
MP	E m p i:
MR	m I s t @
MRS	m I s @ z
MS	E m E s
MSG	E m E s dZ i:
MUCH	m a tS
MUCK	m a k
MUCUS	m j u: k @ s
MUD	m a d
MUDDLE	m a d @ l
MUDGUARD	m a d g a: d
MUESLI	m j u: z l i:
MUFFIN	m a f @ n
MUFFLER	m a f l @
MUG	m a g
MUGGY	m a g i:
MULCH	m a l tS
MULGA	m a l g @
MULL	m a l
MULTICULTURAL	m a l t i: k a l tS @ r @ l
MULTIMEDIA	m a l t i: m i: d i: @
MULTINATIONAL	m a l t i: n A S @ n @ l
MULTIPLE	m a l t @ p @ l
MULTIPLESCLEROSIS	m a l t @ p @ l s k l @ r @U s @ s
MULTIPLE-CHOICE	m a l t @ p @ l tS o: I s
MULTIPLY	m a l t @ p l a: I
MULTIRACIAL	m a l t i: r EI S @ l
MULTITUDE	m a l t @ tS u: d
MUM	m a m
MUMBLE	m a m b @ l
MUMMY	m a m i:
MUMPS	m a m p s
MUNCH	m a n tS
MUNDANE	m a n d EI n
MUNICIPALITY	m j u: n @ s @ p A l @ t i:
MUNICIPALITY	m j u: n I s @ p A l @ t i:
MURAL	m j u: r @ l
MURDER	m @: d @
MURKY	m @: k i:
MURMUR	m @: m @
MUSCLE	m a s @ l
MUSEUM	m j u: z i: @ m
MUSH	m a S
MUSHROOM	m a S r u: m
MUSIC	m j u: z I k
MUSICAL	m j u: z I k @ l
MUSK	m a s k
MUST	m a s t
MUSTARD	m a s t @ d
MUSTER	m a s t @
MUSTY	m a s t i:
MUTATE	m j u: t EI t
MUTE	m j u: t
MUTILATE	m j u: t @ l EI t
MUTINY	m j u: t @ n i:
MUTTER	m a t @
MUTTON	m a t @ n
MUTUAL	m j u: tS u: @ l
MUZZLE	m a z @ l
MY	m a: I
MYOPIA	m a: I @U p i: @
MYRIAD	m I r i: @ d
MYSELF	m a: I s E l f
MYSTERIOUS	m @ s t I@ r i: @ s
MYSTERY	m I s t r i:
MYSTIC	m I s t I k
MYSTIFY	m I s t @ f a: I
MYTH	m I T
MYTHOLOGY	m @ T O l @ dZ i:
N	E n
N/A	E n EI
NAG	n A g
NAIL	n EI l
NAIVE	n a: I i: v
NAKED	n EI k @ d
NAME	n EI m
NAP	n A p
NAPKIN	n A p k @ n
NAPPY	n A p i:
NARCOTIC	n a: k O t I k
NARRATION	n @ r EI S @ n
NARRATIVE	n A r @ t I v
NARROW	n A r @U
NASAL	n EI z @ l
NASTY	n a: s t i:
NATION	n EI S @ n
NATIONAL	n A S n @ l
NATIONALISE	n A S n @ l a: I z
NATIONALISM	n A S n @ l I z @ m
NATIVE	n EI t I v
NATTER	n A t @
NATTY	n A t i:
NATURAL	n A tS @ r @ l
NATURALISED	n A tS @ r @ l a: I z d
NATURE	n EI tS @
NAUGHTY	n o: t i:
NAUSEA	n o: z i: @
NAVEL	n EI v @ l
NAVIGATE	n A v @ g EI t
NAVY	n EI v i:
NB	E n b i:
NE	n o: T i: s t
NEAR	n I@
NEARBY	n I@ b a: I
NEARLY	n I@ l i:
NEAT	n i: t
NECESSARY	n E s @ s E r i:
NECK	n E k
NECKLACE	n E k l @ s
NEE	n EI
NEE	n i:
NEED	n i: d
NEEDLE	n i: d @ l
NEGATIVE	n E g @ t I v
NEGLECT	n @ g l E k t
NEGLIGEE	n E g l @ Z EI
NEGLIGENT	n E g l @ dZ @ n t
NEGLIGIBLE	n E g l @ dZ @ b @ l
NEGOTIABLE	n @ g @U S @ b @ l
NEGOTIATE	n @ g @U S i: EI t
NEIGHBOUR	n EI b @
NEITHER	n a: I D @
NEPHEW	n E f j u:
NERD	n @: d
NERVE	n @: v
NERVOUS	n @: v @ s
NEST	n E s t
NET	n E t
NETBALL	n E t b o: l
NETTLE	n E t @ l
NETWORK	n E t w @: k
NEUROTIC	n j u: r O t I k
NEUTER	n j u: t @
NEUTRAL	n j u: t r @ l
NEVER	n E v @
NEVERTHELESS	n E v @ D @ l E s
NEW	n j u:
NEWINGTON	n j u: I N t @ n
NEWS	n j u: z
NEWSAGENT	n j u: z EI dZ @ n t
NEWSPAPER	n j u: z p EI p @
NEXT	n E k s t
NEXTOFKIN	n E k s t @ v k I n
NIB	n I b
NIBBLE	n I b @ l
NICE	n a: I s
NICHE	n i: S
NICK	n I k
NICKNAME	n I k n EI m
NICOTINE	n I k @ t i: n
NIECE	n i: s
NIFTY	n I f t i:
NIGHT	n a: I t
NIGHTCLOTHES	n a: I t k l @U D z
NIGHTDRESS	n a: I t d r E s
NIGHTMARE	n a: I t m E@
NIGHTSHIRT	n a: I tS @: t
NIL	n I l
NIMBLE	n i: m b @ l
NINE	n a: I n
NINETEEN	n a: I n t i: n
NINETEENTH	n a: I n t i: n T
NINETY	n a: I n t i:
NINTH	n a: I n T
NIP	n I p
NIPPERS	n I p @ z
NIPPLE	n I p @ l
NIT	n I t
NO	n a m b @
NO	n @U
NO-ONE	n @U w a n
NOBLE	n @U b @ l
NOBODY	n @U b O d i:
NOCTURNAL	n O k t @: n @ l
NOD	n O d
NODULE	n O dZ u: l
NOISE	n o: I z
NOMINATE	n O m @ n EI t
NONCHALANT	n O n S @ l @ n t
NONDESCRIPT	n O n d @ s k r I p t
NONE	n a n
NONENTITY	n O n E n t @ t i:
NONETHELESS	n a n D @ l E s
NONFICTION	n O n f I k S @ n
NONFLAMMABLE	n O n f l A m @ b @ l
NONPLUSSED	n O n p l a s t
NONSENSE	n O n s @ n s
NOODLE	n u: d @ l
NOON	n u: n
NOOSE	n u: s
NOR	n o:
NORMAL	n o: m @ l
NORTH	n o: T
NORTHWARD	n o: T w @ d
NOSE	n @U z
NOSTALGIA	n O s t A l dZ @
NOSTRIL	n O s t r @ l
NOT	n O t
NOTABLE	n @U t @ b @ l
NOTCH	n O tS
NOTE	n @U t
NOTHING	n a T I N
NOTICE	n @U t @ s
NOTIFY	n @U t @ f a: I
NOTION	n @U S @ n
NOTORIOUS	n @ t o: r i: @ s
NOUGHT	n o: t
NOUN	n a: U n
NOURISH	n a r I S
NOV	n @U v E m b @
NOV	n @ v E m b @
NOVEL	n O v @ l
NOVELTY	n O v @ l t i:
NOVEMBER	n @U v E m b @
NOVEMBER	n @ v E m b @
NOW	n a: U
NOXIOUS	n O k S @ s
NOZZLE	n O z @ l
NSW	n j u: s a: U T w EI l z
NT	n o: D @ n t E r @ t r i:
NUCLEAR	n j u: k l i: @
NUCLEUS	n j u: k l i: @ s
NUDE	n u: d
NUDGE	n a dZ
NUGGET	n a g @ t
NUISANCE	n j u: s @ n s
NUMB	n a m
NUMBER	n a m b @
NUMBER	n a m @
NUMBERPLATE	n a m b @ p l EI t
NUMERAL	n j u: m @ r @ l
NUMERATOR	n j u: m @ r EI t @
NUMEROUS	n j u: m @ r @ s
NUN	n a n
NURSE	n @: s
NURSERY	n @: s @ r i:
NURSERY	n @: s r i:
NUT	n a t
NUTRITION	n j u: t r I S @ n
NUTRITIONIST	n j u: t r I S @ n i: s t
NW	n o: T w E s t
NYLON	n a: I l O n
O	@U
OAF	@U f
OAKS	@U k s
OAR	o:
OATH	@U T
OBEDIENT	@ b i: d i: @ n t
OBESE	@U b i: s
OBEY	@U b EI
OBJECT	O b dZ E k t
OBJECTIVE	@ b dZ E k t I v
OBLIGE	@ b l a: I dZ
OBLONG	O b l O N
OBSCENE	@ b s i: n
OBSCURE	@ b s k j u: @
OBSERVE	@ b z @: v
OBSESSION	@ b s E S @ n
OBSOLETE	O b s @ l i: t
OBSTACLE	O b s t @ k @ l
OBSTETRICIAN	O b s t @ t r I S @ n
OBSTINATE	O b s t @ n @ t
OBSTRUCT	@ b s t r a k t
OBTAIN	@ b t EI n
OBTUSE	@ b t j u: s
OBVIOUS	O b v i: @ s
OCCASION	@ k EI Z @ n
OCCASIONAL	@ k EI Z @ n @ l
OCCUPATION	O k j @ p EI S @ n
OCCUPIED	O k j @ p a: I d
OCCUPY	O k j @ p a: I
OCCUR	@ k @:
OCEAN	@U S @ n
OCLOCK	@ k l O k
OCTOBER	O k t @U b @
ODD	O d
ODIOUS	@U d i: @ s
ODOUR	@U d @
OF	O v
OFF	O f
OFF-COLOUR	O f k a l @
OFF-PEAK	O f p i: k
OFF-PUTTING	O f p U t I N
OFFENCE	@ f E n s
OFFENSIVE	@ f E n s I v
OFFER	O f @
OFFICE	O f @ s
OFFICER	O f @ s @
OFFICES	O f @ s @ z
OFFICIAL	@ f I S @ l
OFTEN	O f @ n
OH	@U
OIL	o: I l
OINTMENT	o: I n t m @ n t
OK	@U k EI
OKAY	@U k EI
OLD	@U l d
OLDAGE	@U l d EI dZ
OLD-FASHIONED	@U l d f A S @ n d
OLIVE	O l I v
OLIVE	O l @ v
OLYMPICGAMES	@ l I m p I k g EI m z
OMBUDSMAN	O m b @ d z m @ n
OMELETTE	O m l @ t
OMEN	@U m @ n
OMINOUS	O m @ n @ s
OMIT	@U m I t
ON	O n
ONCE	w a n s
ONCOMING	O n k a m I N
ONE	w a n
ONLY	@U n l i:
ONSET	O n s E t
ONTO	O n t @
ONTO	O n t u:
OOZE	u: z
OPAL	@U p @ l
OPAQUE	@U p EI k
OPEN	@U p @ n
OPEN-MINDED	@U p @ n m a: I n d @ d
OPERA	O p r @
OPERATE	O p @ r EI t
OPHTHALMOLOGIST	O f T A l m O l @ dZ @ s t
OPINION	@ p I n j @ n
OPPONENT	@ p @U n @ n t
OPPORTUNITY	O p @ t j u: n @ t i:
OPPORTUNITY	O p @ tS u: n @ t i:
OPPOSE	@ p @U z
OPPOSITE	O p @ s @ t
OPPRESSION	@ p r E S @ n
OPTICIAN	O p t I S @ n
OPTIMISM	O p t @ m I z @ m
OPTION	O p S @ n
OPTOMETRIST	O p t O m @ t r @ s t
OR	o:
ORAL	O r @ l
ORANGE	O r I n dZ
ORATOR	O r @ t @
ORCHARD	o: tS @ d
ORCHESTRA	o: k @ s t r @
ORDEAL	o: d i: l
ORDER	o: d @
ORDINALNUMBER	o: d @ n @ l n a m b @
ORDINARY	o: d @ n r i:
ORDINARY	o: d @ n E r i:
ORGAN	o: g @ n
ORGANIC	o: g A n I k
ORGANISATION	o: g @ n a: I z EI S @ n
ORGANISE	o: g @ n a: I z
ORGANISM	o: g @ n I z @ m
ORGASM	o: g A z @ m
ORGY	o: dZ i:
ORIENTAL	o: r i: E n t @ l
ORIGIN	O r @ dZ @ n
ORIGINAL	@ r I dZ @ n @ l
ORIGINATE	@ r I dZ @ n EI t
ORNAMENT	o: n @ m @ n t
ORPHAN	o: f @ n
ORTHODONTIST	o: T @ d O n t @ s t
ORTHODOX	o: T @ d O k s
ORTHOPAEDICSURGEON	o: T @ p i: d I k s @: dZ @ n
OSTEOPATH	O s t i: @ p A T
OTHER	a D @
OTHERWISE	a D @ w a: I z
OUGHT	o: t
OUR	a: U@
OUR	a: U
OURS	a: U Z
OURS	a: U@ z
OURSELVES	a: U s E l v z
OURSELVES	a: U@ s E l v z
OUT	a: U t
OUTBACK	a: U t b A k
OUTBREAK	a: U t b r EI k
OUTBURST	a: U t b @: s t
OUTCOME	a: U t k a m
OUTCRY	a: U t k r a: I
OUTDOORS	a: U t d o: z
OUTER	a: U t @
OUTFIT	a: U t f I t
OUTGOING	a: U t g @U I N
OUTING	a: U t I N
OUTLINE	a: U t l a: I n
OUTLOOK	a: U t l U k
OUTPATIENT	a: U t p EI S @ n t
OUTRAGE	a: U t r EI dZ
OUTRIGHT	a: U t r a: I t
OUTSET	a: U t s E t
OUTSIDE	a: U t s a: I d
OUTSKIRTS	a: U t s k @: t s
OUTSPOKEN	a: U t s p @U k @ n
OUTSTANDING	a: U t s t A n d I N
OUTWARD	a: U t w @ d
OUTWARDS	a: U t w @ d z
OUTWIT	a: U t w I t
OVAL	@U v @ l
OVARY	@U v @ r i:
OVEN	a v @ n
OVER	@U v @
OVERALLS	@U v @ r o: l z
OVERARM	@U v @ r a: m
OVERAWE	@U v @ r o:
OVERBALANCE	@U v @ b A l @ n s
OVERBEARING	@U v @ b E@ r I N
OVERBOARD	@U v @ b o: d
OVERCAST	@U v @ k a: s t
OVERCOAT	@U v @ k @U t
OVERCOME	@U v @ k a m
OVERDO	@U v @ d u:
OVERDOSE	@U v @ d @U s
OVERDRAFT	@U v @ d r a: f t
OVERDUE	@U v @ d j u:
OVERFLOW	@U v @ f l @U
OVERHAUL	@U v @ h o: l
OVERHEAD	@U v @ h E d
OVERHEAR	@U v @ h I@
OVERLAP	@U v @ l A p
OVERLOOK	@U v @ l U k
OVERNIGHT	@U v @ n a: I t
OVERPOWER	@U v @ p a: U@
OVERRULE	@U v @ r u: l
OVERSEAS	@U v @ s i: z
OVERSIGHT	@U v @ s a: I t
OVERTAKE	@U v @ t EI k
OVERTIME	@U v @ t a: I m
OVERTURN	@U v @ t @: n
OVERWEIGHT	@U v @ w EI t
OVERWHELM	@U v @ w E l m d
OVERWORK	@U v @ w @: k
OVULATE	O v j @ l EI t
OWE	@U
OWL	a: U l
OWN	@U n
OXYGEN	O k s @ dZ @ n
OYSTER	o: I s t @
P	p i:
P&C	p i: @ n s i:
P-PLATE	p i: p l EI t
PA	p @: r A n @ m
PA	p i: EI
PM	p i: E m
PTO	p i: t i: @U
PACE	p EI s
PACIFIST	p A s @ f @ s t
PACIFY	p A s @ f a: I
PACK	p A k
PACKAGE	p A k I dZ
PACKAGING	p A k @ dZ I N
PACKED	p A k t
PACKET	p A k @ t
PACT	p A k t
PAD	p A d
PADDLE	p A d @ l
PADDOCK	p A d @ k
PADLOCK	p A d l O k
PAEDIATRICIAN	p i: d i: @ t r I S @ n
PAGE	p EI dZ
PAID	p EI d
PAID-UP	p EI d a p
PAIN	p EI n
PAINSTAKING	p EI n z t EI k I N
PAINT	p EI n t
PAINTING	p EI n t I N
PAIR	p E@
PAL	p A l
PALACE	p A l @ s
PALATE	p A l @ t
PALE	p EI l
PALM	p a: m
PALPITATE	p A l p @ t EI t
PALTRY	p o: l t r i:
PAMPER	p A m p @
PAMPHLET	p A m f l @ t
PAN	p A n
PANCAKE	p A N k EI k
PANCREAS	p A N k r i: @ s
PANDEMONIUM	p A n d @ m @U n i: @ m
PANDER	p A n d @
PANE	p EI n
PANEL	p A n @ l
PANELVAN	p A n @ l v A n
PANG	p A N
PANIC	p A n I k
PANORAMA	p A n @ r a: m @
PANT	p A n t
PANTIHOSE	p A n t i: h @U z
PANTOMIME	p A n t @ m a: I m
PANTRY	p A n t r i:
PANTS	p A n t s
PAPSMEAR	p A p s m I@
PAPER	p EI p @
PAPERBACK	p EI p @ b A k
PAR	p a:
PARACHUTE	p A r @ S u: t
PARADE	p @ r EI d
PARADISE	p A r @ d a: I s
PARADOX	p A r @ d O k s
PARAGRAPH	p A r @ g r A f
PARALLEL	p A r @ l E l
PARALYSE	p A r @ l a: I z
PARAMEDIC	p A r @ m E d I k
PARAMOUNT	p A r @ m a: U n t
PARANOIA	p A r @ n o: I@
PARAPHERNALIA	p A r @ f @ n EI l j @
PARAPHRASE	p A r @ f r EI z
PARAPLEGIC	p A r @ p l i: dZ I k
PARASITE	p A r @ s a: I t
PARCEL	p a: s @ l
PARDON	p a: d @ n
PARENT	p E@ r @ n t
PARISH	p A r I S
PARK	p a: k
PARKA	p a: k @
PARLIAMENT	p a: l @ m @ n t
PARODY	p A r @ d i:
PAROLE	p @ r @U l
PARQUET	p a: k EI
PARROT	p A r @ t
PARRY	p A r i:
PARSLEY	p a: s l i:
PART	p a: t
PART-TIME	p a: t t a: I m
PARTIAL	p a: S @ l
PARTICIPATE	p @ t I s @ p EI t
PARTICIPLE	p a: t @ s I p @ l
PARTICLE	p a: t I k @ l
PARTICULAR	p @ t I k j @ l @
PARTITION	p @ t I S @ n
PARTNER	p a: t n @
PARTY	p a: t i:
PASS	p a: s
PASSAGE	p A s I dZ
PASSENGER	p A s @ n dZ @
PASSION	p A S @ n
PASSIONFRUIT	p A S @ n f r u: t
PASSIVE	p A s I v
PASSPORT	p a: s p o: t
PASSWORD	p a: s w @: d
PAST	p a: s t
PASTA	p A s t @
PASTE	p EI s t
PASTEL	p A s t @ l
PASTEURISE	p a: s tS @ r a: I z
PASTIME	p a: s t a: I m
PASTRY	p EI s t r i:
PASTURE	p a: s tS @
PASTY	p EI s t i:
PAT	p A t
PATCH	p A tS
PATENT	p EI t @ n t
PATERNAL	p @ t @: n @ l
PATERNITY	p @ t @: n @ t i:
PATH	p a: T
PATHETIC	p @ T E t I k
PATHOLOGY	p @ T O l @ dZ i:
PATIENT	p EI S @ n t
PATIO	p A t i: @U
PATRIARCH	p EI t r i: a: k
PATRIOT	p EI t r i: @ t
PATROL	p @ t r @U l
PATRON	p EI t r @ n
PATRONISE	p A t r @ n a: I z
PATTER	p A t @
PATTERN	p A t @ n
PAUSE	p o: z
PAVE	p EI v
PAVEMENT	p EI v m @ n t
PAVILION	p @ v I l j @ n
PAVLOVA	p A v l @U v @
PAW	p o:
PAWN	p o: n
PAY	p EI
PAYE	p i: EI w a: I i:
PAYROLL	p EI r @U l
PEA	p i:
PEACE	p i: s
PEACH	p i: tS
PEAK	p i: k
PEAL	p i: l
PEARL	p @: l
PEASANT	p E z @ n t
PEAT	p i: t
PEBBLE	p E b @ l
PECK	p E k
PECKISH	p E k I S
PECULIAR	p @ k j u: l i: @
PEDAL	p E d @ l
PEDANTIC	p @ d A n t I k
PEDDLE	p E d @ l
PEDESTAL	p E d @ s t @ l
PEDESTRIAN	p @ d E s t r i: @ n
PEE	p i:
PEEK	p i: k
PEEL	p i: l
PEEP	p i: p
PEER	p I@
PEEVE	p i: v
PEEVISH	p i: v I S
PEG	p E g
PELT	p E l t
PELVIS	p E l v @ s
PEN	p E n
PENAL	p i: n @ l
PENALISE	p i: n @ l a: I z
PENALTY	p E n @ l t i:
PENCIL	p E n s @ l
PENDANT	p E n d @ n t
PENETRATE	p E n @ t r EI t
PENFRIEND	p E n f r E n d
PENGUIN	p E N g w @ n
PENICILLIN	p E n @ s I l @ n
PENINSULA	p @ n I n S @ l @
PENIS	p i: n @ s
PENKNIFE	p E n n a: I f
PENNY	p E n i:
PENSION	p E n S @ n
PENTATHLON	p E n t A T l O n
PENTHOUSE	p E n t h a: U s
PEOPLE	p i: p @ l
PEPPER	p E p @
PEPPERMINT	p E p @ m @ n t
PER	p @:
PERCENT	p @ s E n t
PERCEIVE	p @ s i: v
PERCEPTION	p @ s E p S @ n
PERCH	p @: tS
PERCOLATE	p @: k @ l EI t
PERFECT	p @: f E k t
PERFORM	p @ f o: m
PERFUME	p @: f j u: m
PERGOLA	p @ g @U l @
PERHAPS	p @ h A p s
PERIL	p E r @ l
PERIOD	p I@ r i: @ d
PERIODICAL	p I@ r i: O d I k @ l
PERIPHERAL	p @ r I f @ r @ l
PERISH	p E r I S
PERISHABLE	p E r I S @ b @ l
PERJURE	p @: dZ @
PERK	p @: k
PERMANENT	p @: m @ n @ n t
PERMISSION	p @ m I S @ n
PERMIT	p @ m I t
PERPETRATE	p @: p @ t r EI t
PERPETUAL	p @ p E tS u: @ l
PERSECUTE	p @: s @ k j u: t
PERSEVERE	p @: s @ v I@
PERSIAN	p @: Z @ n
PERSIST	p @ s I s t
PERSON	p @: s @ n
PERSONAL	p @: s @ n @ l
PERSONALITY	p @: s @ n A l @ t i:
PERSONIFY	p @ s O n @ f a: I
PERSONNEL	p @: s @ n E l
PERSPIRE	p @ s p a: I@
PERSUADE	p @ s w EI d
PERT	p @: t
PERTINENT	p @: t @ n @ n t
PERTURB	p @ t @: b
PERVERSE	p @ v @: s
PERVERT	p @: v @: t
PESSIMISM	p E s @ m I z @ m
PEST	p E s t
PESTER	p E s t @
PET	p E t
PETAL	p E t @ l
PETEROUT	p i: t @ a: U t
PETITE	p @ t i: t
PETITION	p @ t I S @ n
PETRIFY	p E t r @ f a: I
PETROL	p E t r @ l
PETROLEUM	p @ t r @U l i: @ m
PETTICOAT	p E t i: k @U t
PETTY	p E t i:
PETULANT	p E tS @ l @ n t
PEWTER	p j u: t @
PHANTOM	f A n t @ m
PHARMACIST	f a: m @ s @ s t
PHASE	f EI z
PHENOMENAL	f @ n O m @ n @ l
PHENOMENON	f @ n O m @ n @ n
PHEW	f j u:
PHILOSOPHY	f @ l O s @ f i:
PHLEGM	f l E m
PHLEGMATIC	f l E g m A t I k
PHOBIA	f @U b i: @
PHONE	f @U n
PHONETICS	f @ n E t I k s
PHONEY	f @U n i:
PHOTO	f @U t @U
PHOTOCOPY	f @U t @U k O p i:
PHOTOGENIC	f @U t @ dZ i: n I k
PHOTOGRAPH	f @U t @ g r A f
PHRASE	f r EI z
PHYSICAL	f I z I k @ l
PHYSICIAN	f @ z I S @ n
PHYSICS	f I z I k s
PHYSIOLOGY	f I z i: O l @ dZ i:
PHYSIOTHERAPIST	f I z i: @U T E r @ p @ s t
PHYSIQUE	f @ z i: k
PIANO	p i: A n @U
PICK	p I k
PICKET	p I k @ t
PICKLE	p I k @ l
PICKPOCKET	p I k p O k @ t
PICNIC	p I k n I k
PICTORIAL	p I k t o: r i: @ l
PICTURE	p I k tS @
PIDGIN	p I dZ @ n
PIE	p a: I
PIECE	p i: s
PIER	p I@
PIERCE	p I@ s
PIG	p I g
PIG-HEADED	p I g h E d @ d
PIGMENT	p I g m @ n t
PIGSTY	p I g s t a: I
PILE	p a: I l
PILE-UP	p a: I l a p
PILFER	p I l f @
PILGRIM	p I l g r @ m
PILIPINO	p I l @ p i: n @U
PILL	p I l
PILLAR	p I l @
PILLOW	p I l @U
PILLOWCASE	p I l @U k EI s
PILOT	p a: I l @ t
PIMPLE	p I m p @ l
PIN	p I n
PIN-UP	p I n a p
PINCH	p I n tS
PINE	p a: I n
PING-PONG	p I N p O N
PINK	p I N k
PIONEER	p a: I@ n I@
PIOUS	p a: I@ s
PIP	p I p
PIPE	p a: I p
PIRATE	p a: I r @ t
PISTOL	p I s t @ l
PISTON	p I s t @ n
PIT	p I t
PITCH	p I tS
PITCH-DARK	p I tS d a: k
PITFALL	p I t f o: l
PITH	p I T
PITIFUL	p I t @ f @ l
PITTANCE	p I t @ n s
PITY	p I t i:
PIVOT	p I v @ t
PLACATE	p l @ k EI t
PLACE	p l EI s
PLACID	p l A s @ d
PLAGUE	p l EI g
PLAIN	p l EI n
PLAIT	p l A t
PLAN	p l A n
PLANE	p l EI n
PLANET	p l A n @ t
PLANK	p l A N k
PLANT	p l A n t
PLAQUE	p l a: k
PLASTER	p l a: s t @
PLASTERED	p l a: s t @ d
PLASTIC	p l A s t I k
PLASTICSURGERY	p l A s t I k s @: dZ @ r i:
PLATE	p l EI t
PLATEAU	p l A t @U
PLATFORM	p l A t f o: m
PLATTER	p l A t @
PLATYPUS	p l A t @ p U s
PLAUSIBLE	p l o: z @ b @ l
PLAY	p l EI
PLAYGROUND	p l EI g r a: U n d
PLAYWRIGHT	p l EI r a: I t
PLEA	p l i:
PLEAD	p l i: d
PLEASANT	p l E z @ n t
PLEASE	p l i: z
PLEASURE	p l E Z @
PLEAT	p l i: t
PLEDGE	p l E dZ
PLENTY	p l E n t i:
PLIABLE	p l a: I@ b @ l
PLIERS	p l a: I@ z
PLIGHT	p l a: I t
PLOD	p l O d
PLONK	p l O N k
PLOT	p l O t
PLOUGH	p l a: U
PLOY	p l o: I
PLUCK	p l a k
PLUCKY	p l a k i:
PLUG	p l a g
PLUGHOLE	p l a g h @U l
PLUMBER	p l a m @
PLUMMET	p l a m @ t
PLUMP	p l a m p
PLUNGE	p l a n dZ
PLURAL	p l U@ r @ l
PLUS	p l a s
PLUSH	p l a S
PLY	p l a: I
PLYWOOD	p l a: I w U d
PNEUMONIA	n j u: m @U n j @
PO	p i: @U
POACH	p @U tS
POCKET	p O k @ t
POCKETMONEY	p O k @ t m a n i:
POD	p O d
PODGY	p O dZ i:
POEM	p @U @ m
POETRY	p @U @ t r i:
POINT	p o: I n t
POINT-BLANK	p o: I n t b l A N k
POINTLESS	p o: I n t l @ s
POISE	p o: I z
POISON	p o: I z @ n
POKE	p @U k
POKER	p @U k @
POKY	p @U k i:
POLE	p @U l
POLICE	p @ l i: s
POLICY	p O l @ s i:
POLIO	p @U l i: @U
POLISH	p O l I S
POLISH	p @U l I S
POLITE	p @ l a: I t
POLITICIAN	p O l @ t I S @ n
POLITICS	p O l @ t I k s
POLL	p O l
POLLEN	p O l @ n
POLLUTE	p @ l u: t
POLO	p @U l @U
POMMY	p O m i:
POMPOUS	p O m p @ s
POND	p O n d
PONDER	p O n d @
PONG	p O N
PONY	p @U n i:
PONYTAIL	p @U n i: t EI l
POO	p u:
POOH	p u:
POOL	p u: l
POOR	p o:
POP	p O p
POPE	p @U p
POPULAR	p O p j @ l @
POPULATE	p O p j @ l EI t
PORCH	p o: tS
PORE	p o:
PORK	p o: k
PORNOGRAPHY	p o: n O g r @ f i:
POROUS	p o: r @ s
PORRIDGE	p O r I dZ
PORT	p o: t
PORTABLE	p o: t @ b @ l
PORTER	p o: t @
PORTFOLIO	p o: t f @U l i: @U
PORTION	p o: S @ n
PORTRAIT	p o: t r @ t
PORTRAY	p o: t r EI
PORTUGUESE	p o: tS @ g i: z
POSE	p @U z
POSH	p O S
POSITION	p @ z I S @ n
POSITIVE	p O z @ t I v
POSSESS	p @ z E s
POSSESSION	p @ z E S @ n
POSSESSIVE	p @ z E s I v
POSSIBLE	p O s @ b @ l
POSSUM	p O s @ m
POST	p @U s t
POSTOFFICE	p @U s t O f @ s
POST-MORTEM	p @U s t m o: t @ m
POST-OFFICEBOX	p @U s t O f @ s b O k s
POSTAL-LABEL	p @U s t @ l l EI b @ l
POSTBOX	p @U s t b O k s
POSTCARD	p @U s t k a: d
POSTCODE	p @U s t k @U d
POSTER	p @U s t @
POSTERIOR	p O s t I@ r i: @
POSTERITY	p O s t E r @ t i:
POSTGRADUATE	p @U s t g r A dZ u: @ t
POSTMAN	p @U s t m @ n
POSTPONE	p @U s t p @U n
POSTSCRIPT	p @U s t s k r I p t
POSTURE	p O s tS @
POSY	p @U z i:
POT	p O t
POTATO	p @ t EI t @U
POTENT	p @U t @ n t
POTENTIAL	p @ t E n S @ l
POTHOLE	p O t h @U l
POTTER	p O t @
POTTY	p O t i:
POUCH	p a: U tS
POULTRY	p @U l t r i:
POUNCE	p a: U n s
POUND	p a: U n d
POUR	p o:
POUT	p a: U t
POVERTY	p O v @ t i:
POWDER	p a: U d @
POWER	p a: U@
PRACTICAL	p r A k t I k @ l
PRACTICALLY	p r A k t I k l i:
PRACTICE	p r A k t @ s
PRACTISE	p r A k t @ s
PRAISE	p r EI z
PRAM	p r A m
PRANCE	p r A n s
PRANK	p r A N k
PRATTLE	p r A t @ l
PRAWN	p r o: n
PRAY	p r EI
PREACH	p r i: tS
PRECARIOUS	p r @ k E@ r i: @ s
PRECAUTION	p r @ k o: S @ n
PRECEDE	p r @ s i: d
PRECEDE	p r i: s i: d
PRECEDENT	p r i: s @ d @ n t
PRECIOUS	p r E S @ s
PRECIPICE	p r E s @ p @ s
PRECIS	p r EI s i:
PRECISE	p r @ s a: I s
PRECOCIOUS	p r @ k @U S @ s
PREDECESSOR	p r i: d @ s E s @
PREDICAMENT	p r @ d I k @ m @ n t
PREDICT	p r @ d I k t
PREDICTABLE	p r @ d I k t @ b @ l
PREDOMINANT	p r @ d O m @ n @ n t
PREEN	p r i: n
PREFACE	p r E f @ s
PREFECT	p r i: f E k t
PREFER	p r @ f @:
PREFIX	p r i: f I k s
PREGNANT	p r E g n @ n t
PREJUDICE	p r E dZ @ d @ s
PRELIMINARY	p r @ l I m @ n r i:
PRELUDE	p r E l j u: d
PREMATURE	p r E m @ tS @
PREMATURE	p r E m @ tS U@
PREMIER	p r E m i: @
PREMIERE	p r E m i: E@
PREMISE	p r E m @ s
PREMIUM	p r i: m i: @ m
PREMONITION	p r E m @ n I S @ n
PREOCCUPIED	p r i: O k j @ p a: I d
PREPARE	p r @ p E@
PREPOSITION	p r E p @ z I S @ n
PREPOSTEROUS	p r @ p O s t r @ s
PRESCRIBE	p r @ s k r a: I b
PRESCRIPTION	p r @ s k r I p S @ n
PRESENT	p r E z @ n t
PRESENTABLE	p r @ z E n t @ b @ l
PRESENTLY	p r E z @ n t l i:
PRESERVE	p r @ z @: v
PRESIDENT	p r E z @ d @ n t
PRESS	p r E s
PRESS-UP	p r E s a p
PRESSURE	p r E S @
PRESTIGE	p r E s t i: Z
PRESUME	p r @ z j u: m
PRETEND	p r @ t E n d
PRETTY	p r I t i:
PREVALENT	p r E v @ l @ n t
PREVARICATE	p r @ v A r @ k EI t
PREVENT	p r @ v E n t
PREVIEW	p r i: v j u:
PREVIOUS	p r i: v i: @ s
PREY	p r EI
PRICE	p r a: I s
PRICELESS	p r a: I s l @ s
PRICEY	p r a: I s i:
PRICK	p r I k
PRIDE	p r a: I d
PRIEST	p r i: s t
PRIG	p r I g
PRIM	p r I m
PRIMARY	p r a: I m @ r i:
PRIMARYSCHOOL	p r a: I m r i: s k u: l
PRIME	p r a: I m
PRIMEMINISTER	p r a: I m m I n @ s t @
PRIMENUMBER	p r a: I m n a m b @
PRIMITIVE	p r I m @ t I v
PRINCE	p r I n s
PRINCESS	p r I n s E s
PRINCIPAL	p r I n s @ p @ l
PRINCIPLE	p r I n s @ p @ l
PRINT	p r I n t
PRINTER	p r I n t @
PRIOR	p r a: I@
PRIORITY	p r a: I O r @ t i:
PRISE	p r a: I z
PRISM	p r I z @ m
PRISON	p r I z @ n
PRIVATE	p r a: I v @ t
PRIVILEGE	p r I v @ l I dZ
PRIZE	p r a: I z
PRORATA	p r @U r a: t @
PROBABLE	p r O b @ b @ l
PROBE	p r @U b
PROBLEM	p r O b l @ m
PROCEDURE	p r @ s i: dZ @
PROCEED	p r @ s i: d
PROCESS	p r @U s E s
PROD	p r O d
PRODIGY	p r O d @ dZ i:
PRODUCE	p r O dZ u: s
PRODUCE	p r @ d j u: s
PRODUCT	p r O d a k t
PRODUCTIVE	p r @ d a k t I v
PROFESSION	p r @ f E S @ n
PROFESSOR	p r @ f E s @
PROFICIENT	p r @ f I S @ n t
PROFILE	p r @U f a: I l
PROFIT	p r O f @ t
PROFOUND	p r @ f a: U n d
PROGRAM	p r @U g r A m
PROGRAMME	p r @U g r A m
PROGRESS	p r @U g r E s
PROGRESSIVE	p r @ g r E s I v
PROHIBIT	p r @ h I b @ t
PROJECT	p r @U dZ E k t
PROLOGUE	p r @U l O g
PROLONG	p r @ l O N
PROMENADE	p r O m @ n a: d
PROMINENT	p r O m @ n @ n t
PROMISE	p r O m @ s
PROMOTE	p r @ m @U t
PROMPT	p r O m p t
PRONE	p r @U n
PRONG	p r O N
PRONOUN	p r @U n a: U n
PRONOUNCE	p r @ n a: U n s
PRONOUNCED	p r @ n a: U n s t
PROOF	p r u: f
PROP	p r O p
PROPAGANDA	p r O p @ g A n d @
PROPEL	p r @ p E l
PROPER	p r O p @
PROPERTY	p r O p @ t i:
PROPORTION	p r @ p o: S @ n
PROPOSE	p r @ p @U z
PROPRIETARYLIMITEDCOMPANY	p r @ p r a: I@ t r i: l I m @ t @ d k a m p @ n i:
PROPRIETOR	p r @ p r a: I@ t @
PROSE	p r @U z
PROSECUTE	p r O s @ k j u: t
PROSPECT	p r O s p E k t
PROSPECTUS	p r @ s p E k t @ s
PROSPER	p r O s p @
PROSTITUTE	p r O s t @ t j u: t
PROTECT	p r @ t E k t
PROTECTIVE	p r @ t E k t I v
PROTEIN	p r @U t i: n
PROTEST	p r @ t E s t
PROTESTANT	p r O t @ s t @ n t
PROTOCOL	p r @U t @ k O l
PROTOTYPE	p r @U t @U t a: I p
PROTOTYPE	p r @U t @ t a: I p
PROTRACTED	p r @ t r A k t @ d
PROUD	p r a: U d
PROVE	p r u: v
PROVIDE	p r @ v a: I d
PROVISION	p r @ v I Z @ n
PROVISIONAL	p r @ v I Z @ n @ l
PROVOKE	p r @ v @U k
PROWL	p r a: U l
PROXY	p r O k s i:
PRUDENT	p r u: d @ n t
PRUNE	p r u: n
PRY	p r a: I
PS	p i: E s
PSEUDONYM	s j u: d @ n I m
PSYCH	s a: I k
PSYCHE	s a: I k i:
PSYCHIATRIST	s @ k a: I@ t r @ s t
PSYCHIC	s a: I k I k
PSYCHO	s a: I k @U
PSYCHOANALYST	s a: I k @U A n @ l @ s t
PSYCHOLOGY	s a: I k O l @ dZ i:
PUB	p a b
PUBERTY	p j u: b @ t i:
PUBIC	p j u: b I k
PUBLIC	p a b l I k
PUBLICRELATIONS	p a b l I k r @ l EI S @ n z
PUBLICSCHOOL	p a b l I k s k u: l
PUBLICSERVANT	p a b l I k s @: v @ n t
PUBLICSERVICE	p a b l I k s @: v @ s
PUBLICAN	p a b l I k @ n
PUBLICATION	p a b l @ k EI S @ n
PUBLICITY	p a b l I s @ t i:
PUBLISH	p a b l I S
PUCKER	p a k @
PUDDING	p U d I N
PUDDLE	p a d @ l
PUFF	p a f
PUGNACIOUS	p a g n EI S @ s
PULL	p U l
PULLOVER	p U l @U v @
PULP	p a l p
PULSE	p a l s
PUMP	p a m p
PUMPKIN	p a m p k @ n
PUN	p a n
PUNCH	p a n tS
PUNCTUAL	p a N k tS u: @ l
PUNCTUATION	p a N k tS u: EI S @ n
PUNCTURE	p a N k tS @
PUNISH	p a n I S
PUNT	p a n t
PUNY	p j u: n i:
PUP	p a p
PUPIL	p j u: p @ l
PUPPET	p a p @ t
PURCHASE	p @: tS @ s
PURE	p j u: @
PUREE	p j u: r EI
PURGE	p @: dZ
PURPLE	p @: p @ l
PURPOSE	p @: p @ s
PURR	p @:
PURSE	p @: s
PURSUE	p @ s j u:
PUS	p a s
PUSH	p U S
PUSH-UP	p U S a p
PUSHED	p U S t
PUSHER	p U S @
PUSHOVER	p U S @U v @
PUT	p U t
PUTTY	p a t i:
PUZZLE	p a z @ l
PYJAMAS	p @ dZ a: m @ z
PYLON	p a: I l O n
PYRAMID	p I r @ m I d
PYTHON	p a: I T @ n
Q	k j u:
QC	k j u: s i:
QLD	k w i: n z l A n d
QLD	k w i: n z l @ n d
QUACK	k w A k
QUADRANGLE	k w O d r A N g @ l
QUADRIPLEGIC	k w O d r @ p l i: dZ I k
QUADRUPED	k w O d r @ p E d
QUADRUPLE	k w O d r u: p @ l
QUADRUPLET	k w O d r u: p l @ t
QUAINT	k w EI n t
QUAKE	k w EI k
QUALIFY	k w O l @ f a: I
QUALITY	k w O l @ t i:
QUANTITY	k w O n t @ t i:
QUARANTINE	k w O r @ n t i: n
QUARREL	k w O r @ l
QUARRY	k w O r i:
QUARTER	k w o: t @
QUARTET	k w o: t E t
QUAY	k i:
QUEEN	k w i: n
QUEER	k w I@
QUERY	k w I@ r i:
QUEST	k w E s t
QUESTION	k w E s tS @ n
QUESTIONNAIRE	k w E s tS @ n E@
QUEUE	k j u:
QUIBBLE	k w I b @ l
QUICHE	k i: S
QUICK	k w I k
QUICKSAND	k w I k s A n d
QUIET	k w a: I@ t
QUILT	k w I l t
QUININE	k w I n i: n
QUIP	k w I p
QUIT	k w I t
QUITE	k w a: I t
QUIZ	k w I z
QUORUM	k w o: r @ m
QUOTA	k w @U t @
QUOTATION	k w @U t EI S @ n
QUOTATIONMARKS	k w @U t EI S @ n m a: k s
QUOTE	k w @U t
R	a:
RABBI	r A b a: I
RABBLE	r A b @ l
RACE	r EI s
RACECOURSE	r EI s k o: s
RACIST	r EI s @ s t
RACK	r A k
RACKET	r A k @ t
RACQUET	r A k @ t
RADAR	r EI d a:
RADIATION	r EI d i: EI S @ n
RADIATOR	r EI d i: EI t @
RADICAL	r A d I k @ l
RADIO	r EI d i: @U
RADIOACTIVE	r EI d i: @U A k t I v
RADIOGRAPHY	r EI d i: O g r @ f i:
RADIOLOGIST	r EI d i: O l @ dZ @ s t
RADIOTHERAPY	r EI d i: @U T E r @ p i:
RADISH	r A d I S
RADIUS	r EI d i: @ s
RAFFLE	r A f @ l
RAFTER	r a: f t @
RAG	r A g
RAGE	r EI dZ
RAGGED	r A g @ d
RAID	r EI d
RAIL	r EI l
RAILING	r EI l I N
RAILWAY	r EI l w EI
RAIN	r EI n
RAINBOW	r EI n b @U
RAINFOREST	r EI n f O r @ s t
RAISE	r EI z
RAISIN	r EI z @ n
RAKE	r EI k
RALLY	r A l i:
RAM	r A m
RAMBLE	r A m b @ l
RAMP	r A m p
RAMSHACKLE	r A m S A k @ l
RAN	r A n
RANDOM	r A n d @ m
RANG	r A N
RANGE	r EI n dZ
RANGER	r EI n dZ @
RANK	r A N k
RANSACK	r A n s A k
RANSOM	r A n s @ m
RAPE	r EI p
RAPID	r A p @ d
RARE	r E@
RASH	r A S
RASHER	r A S @
RAT	r A t
RATE	r EI t
RATHER	r a: D @
RATIO	r EI S i: @U
RATION	r A S @ n
RATSHIT	r A tS I t
RATTLE	r A t @ l
RAVE	r EI v
RAVENOUS	r A v @ n @ s
RAVINE	r @ v i: n
RAVISHING	r A v @ S I N
RAW	r o:
RAY	r EI
RAZOR	r EI z @
RE	r i:
RE-COUNT	r i: k a: U n t
REACH	r i: tS
REACT	r i: A k t
READ	r i: d
READY	r E d i:
REAL	r i: l
REALESTATE	r i: l @ s t EI t
REALISE	r i: @ l a: I z
REALIST	r i: @ l @ s t
REALITY	r i: A l @ t i:
REALLY	r I@ l i:
REALTY	r i: @ l t i:
REAR	r I@
REASON	r i: z @ n
REASONABLE	r i: z @ n @ b @ l
REBATE	r i: b EI t
REBEL	r E b @ l
RECALL	r @ k o: l
RECEDE	r @ s i: d
RECEIPT	r @ s i: t
RECEIVE	r @ s i: v
RECEIVER	r @ s i: v @
RECENT	r i: s @ n t
RECEPTACLE	r @ s E p t @ k @ l
RECEPTION	r @ s E p S @ n
RECEPTIONIST	r @ s E p S @ n @ s t
RECESS	r @ s E s
RECESSION	r @ s E S @ n
RECIPE	r E s @ p i:
RECIPIENT	r @ s I p i: @ n t
RECITAL	r @ s a: I t @ l
RECITE	r @ s a: I t
RECKLESS	r E k l @ s
RECKON	r E k @ n
RECOGNISE	r E k @ g n a: I z
RECOIL	r @ k o: I l
RECOLLECT	r E k @ l E k t
RECOMMEND	r E k @ m E n d
RECONCILE	r E k @ n s a: I l
RECORD	r @ k o: d
RECORD-PLAYER	r E k o: d p l EI @
RECORDER	r @ k o: d @
RECOUNT	r @ k a: U n t
RECOVER	r @ k a v @
RECREATION	r E k r i: EI S @ n
RECRUIT	r @ k r u: t
RECTANGLE	r E k t A N g @ l
RECTUM	r E k t @ m
RECUPERATE	r @ k u: p @ r EI t
RECUR	r @ k @:
RECYCLE	r i: s a: I k @ l
RED	r E d
REDTAPE	r E d t EI p
RED-BACK	r E d b A k
REDEEM	r @ d i: m
REDUCE	r @ d j u: s
REDUNDANT	r @ d a n d @ n t
REEF	r i: f
REEL	r i: l
REFER	r @ f @:
REFEREE	r E f @ r i:
REFERENCE	r E f r @ n s
REFERENDUM	r E f @ r E n d @ m
REFLECT	r @ f l E k t
REFLEX	r i: f l E k s
REFLEXIVEPRONOUN	r @ f l E k s I v p r @U n a: U n
REFORM	r @ f o: m
REFRAIN	r @ f r EI n
REFRESH	r @ f r E S
REFRESHMENTS	r @ f r E S m @ n t s
REFRIGERATOR	r @ f r I dZ @ r EI t @
REFUGE	r E f j u: dZ
REFUGEE	r E f j u: dZ i:
REFUND	r i: f a n d
REFUSE	r @ f j u: z
REGAIN	r @ g EI n
REGARD	r @ g a: d
REGARDLESS	r @ g a: d l @ s
REGIME	r EI Z i: m
REGION	r i: dZ @ n
REGISTER	r E dZ @ s t @
REGISTRY	r E dZ @ s t r i:
REGISTRYOFFICE	r E dZ @ s t r i: O f @ s
REGO	r E dZ @U
REGRET	r @ g r E t
REGULAR	r E g j @ l @
REGULATE	r E g j @ l EI t
REGULATION	r E g j @ l EI S @ n
REHABILITATE	r i: h @ b I l @ t EI t
REHEARSE	r @ h @: s
REIGN	r EI n
REIMBURSE	r i: I m b @: s
REIN	r EI n
REINCARNATION	r i: I n k a: n EI S @ n
REINFORCE	r i: I n f o: s
REINFORCEMENTS	r i: I n f o: s m @ n t s
REINSTATE	r i: I n s t EI t
REJECT	r @ dZ E k t
REJOICE	r @ dZ o: I s
RELAPSE	r @ l A p s
RELATE	r @ l EI t
RELATION	r @ l EI S @ n
RELATIONSHIP	r @ l EI S @ n S I p
RELATIVE	r E l @ t I v
RELATIVEPRONOUN	r E l @ t I v p r @U n a: U n
RELATIVELY	r E l @ t I v l i:
RELAX	r @ l A k s
RELAY	r i: l EI
RELEASE	r @ l i: s
RELENT	r @ l E n t
RELENTLESS	r @ l E n t l @ s
RELEVANT	r E l @ v @ n t
RELIABLE	r @ l a: I@ b @ l
RELIANT	r @ l a: I@ n t
RELIC	r E l I k
RELIEF	r @ l i: f
RELIEVE	r @ l i: v
RELIGION	r @ l I dZ @ n
RELUCTANT	r @ l a k t @ n t
RELY	r @ l a: I
REMAIN	r @ m EI n
REMAINDER	r @ m EI n d @
REMARK	r @ m a: k
REMARKABLE	r @ m a: k @ b @ l
REMARRY	r i: m A r i:
REMEDY	r E m @ d i:
REMEMBER	r @ m E m b @
REMIND	r @ m a: I n d
REMITTANCE	r @ m I t @ n s
REMNANT	r E m n @ n t
REMOTE	r @ m @U t
REMOVALIST	r @ m u: v @ l @ s t
REMOVE	r @ m u: v
RENAL	r i: n @ l
RENEW	r @ n j u:
RENOUNCE	r @ n a: U n s
RENOVATE	r E n @ v EI t
RENT	r E n t
RENTAL	r E n t @ l
REPAIR	r @ p E@
REPAY	r i: p EI
REPAYMENT	r @ p EI m @ n t
REPEAT	r @ p i: t
REPEATED	r @ p i: t @ d
REPEL	r @ p E l
REPELLENT	r @ p E l @ n t
REPENT	r @ p E n t
REPLACE	r @ p l EI s
REPLAY	r i: p l EI
REPLICA	r E p l I k @
REPLY	r @ p l a: I
REPORT	r @ p o: t
REPORTER	r @ p o: t @
REPOSSESS	r i: p @ z E s
REPRESENT	r E p r @ z E n t
REPRESENTATIVE	r E p r @ z E n t @ t I v
REPRIEVE	r @ p r i: v
REPRIMAND	r E p r @ m a: n d
REPRINT	r i: p r I n t
REPROACH	r @ p r @U tS
REPRODUCE	r i: p r @ d j u: s
REPTILE	r E p t a: I l
REPUBLIC	r @ p a b l I k
REPUGNANT	r @ p a g n @ n t
REPULSIVE	r @ p a l s I v
REPUTABLE	r E p j @ t @ b @ l
REPUTATION	r E p j @ t EI S @ n
REPUTED	r @ p j u: t @ d
REQUEST	r @ k w E s t
REQUIRE	r @ k w a: I@
RESCUE	r E s k j u:
RESEARCH	r @ s @: tS
RESEMBLE	r @ z E m b @ l
RESENT	r @ z E n t
RESERVATION	r E z @ v EI S @ n
RESERVE	r @ z @: v
RESERVEPRICE	r @ z @: v p r a: I s
RESERVED	r @ z @: v d
RESERVOIR	r E z @ v w a:
RESIDENCE	r E z @ d @ n s
RESIDENT	r E z @ d @ n t
RESIDENTIAL	r E z @ d E n S @ l
RESIDUE	r E z @ d j u:
RESIGN	r @ z a: I n
RESIST	r @ z I s t
RESISTANT	r @ z I s t @ n t
RESOLUTE	r E z @ l u: t
RESOLUTION	r E z @ l u: S @ n
RESOLVE	r @ z O l v
RESORT	r @ z o: t
RESOURCE	r @ z o: s
RESOURCEFUL	r @ z o: s f U l
RESPECT	r @ s p E k t
RESPECTABLE	r @ s p E k t @ b @ l
RESPECTIVELY	r @ s p E k t I v l i:
RESPIRATION	r E s p @ r EI S @ n
RESPOND	r @ s p O n d
RESPONSIBLE	r @ s p O n s @ b @ l
REST	r E s t
RESTAURANT	r E s t @ r O n t
RESTLESS	r E s t l @ s
RESTORE	r @ s t o:
RESTRAIN	r @ s t r EI n
RESTRAINED	r @ s t r EI n d
RESTRICT	r @ s t r I k t
RESULT	r @ z a l t
RESUM;AAE	r E Z j u: m EI
RESUME	r @ z j u: m
RESURRECT	r E z @ r E k t
RESUSCITATE	r @ s a s @ t EI t
RETAIL	r i: t EI l
RETAIN	r @ t EI n
RETALIATE	r @ t A l i: EI t
RETIRE	r @ t a: I@
RETRACE	r i: t r EI s
RETREAT	r @ t r i: t
RETRENCH	r @ t r E n tS
RETRIEVE	r @ t r i: v
RETROSPECTIVE	r E t r @ s p E k t I v
RETURN	r @ t @: n
REUNION	r i: j u: n j @ n
REVEAL	r @ v i: l
REVEL	r E v @ l
REVENGE	r @ v E n dZ
REVENUE	r E v @ n j u:
REVEREND	r E v r @ n d
REVERENT	r E v r @ n t
REVERSE	r @ v @: s
REVERT	r @ v @: t
REVIEW	r @ v j u:
REVISE	r @ v a: I z
REVIVE	r @ v a: I v
REVOLT	r @ v @U l t
REVOLUTION	r E v @ l u: S @ n
REVOLUTIONARY	r E v @ l u: S @ n r i:
REVOLVE	r @ v O l v
REVOLVER	r @ v O l v @
REWARD	r @ w o: d
REWARDING	r @ w o: d I N
RHEUMATISM	r u: m @ t I z @ m
RHYME	r a: I m
RHYTHM	r I D @ m
RIB	r I b
RIBBON	r I b @ n
RICE	r a: I s
RICH	r I tS
RID	r I d
RIDDLE	r I d @ l
RIDE	r a: I d
RIDGE	r I dZ
RIDICULE	r I d @ k j u: l
RIDICULOUS	r @ d I k j @ l @ s
RIFLE	r a: I f @ l
RIFT	r I f t
RIG	r I g
RIGHT	r a: I t
RIGHTFUL	r a: I t f @ l
RIGID	r I dZ @ d
RIM	r I m
RIND	r a: I n d
RING	r I N
RING-IN	r I N I n
RINGWORM	r I N w @: m
RINSE	r I n s
RIOT	r a: I@ t
RIP	r I p
RIPCORD	r I p k o: d
RIPE	r a: I p
RIPPLE	r I p @ l
RISE	r a: I z
RISK	r I s k
RIVAL	r a: I v @ l
RIVER	r I v @
ROAD	r @U d
ROADWAY	r @U d w EI
ROADWORKS	r @U d w @: k s
ROAM	r @U m
ROAR	r o:
ROAST	r @U s t
ROB	r O b
ROBBERY	r O b @ r i:
ROBE	r @U b
ROBOT	r @U b O t
ROBUST	r @U b a s t
ROCK	r O k
ROCKERY	r O k @ r i:
ROCKET	r O k @ t
ROD	r O d
RODE	r @U d
ROGUE	r @U g
ROLE	r @U l
ROLL	r @U l
ROLLER-SKATE	r @U l @ s k EI t
ROM	r O m
ROMAN	r @U m @ n
ROMANCE	r @U m A n s
ROMANCE	r @ m A n s
ROMANIAN	r @U m EI n i: @ n
ROMP	r O m p
ROOF	r u: f
ROOM	r u: m
ROOMS	r u: m z
ROOSTER	r u: s t @
ROOT	r u: t
ROPE	r @U p
ROPEABLE	r @U p @ b @ l
RORT	r o: t
ROSE	r @U z
ROSTER	r O s t @
ROSY	r @U z i:
ROT	r O t
ROTATE	r @U t EI t
ROTTEN	r O t @ n
ROUGH	r a f
ROUGHAGE	r a f I dZ
ROULETTE	r u: l E t
ROUND	r a: U n d
ROUNDABOUT	r a: U n d @ b a: U t
ROUSE	r a: U z
ROUTE	r u: t
ROUTINE	r u: t i: n
ROW	r @U
ROWDY	r a: U d i:
ROYAL	r o: I@ l
ROYALTY	r o: I@ l t i:
RSL	a: r E s E l
RSVP	a: r E s v i: p i:
RUB	r a b
RUBBER	r a b @
RUBBISH	r a b I S
RUBBLE	r a b @ l
RUBELLA	r u: b E l @
RUBY	r u: b i:
RUCKSACK	r a k s A k
RUDDER	r a d @
RUDDY	r a d i:
RUDE	r u: d
RUFFIAN	r a f i: @ n
RUG	r a g
RUGBY	r a g b i:
RUGGED	r a g @ d
RUIN	r u: @ n
RULE	r u: l
RULER	r u: l @
RUM	r a m
RUMBLE	r a m b @ l
RUMMAGE	r a m I dZ
RUMOUR	r u: m @
RUMP	r a m p
RUMPLE	r a m p @ l
RUMPUS	r a m p @ s
RUN	r a n
RUN-DOWN	r a n d a: U n
RUNG	r a N
RUNNER-UP	r a n @ r a p
RUNNY	r a n i:
RUNT	r a n t
RUNWAY	r a n w EI
RUPTURE	r a p tS @
RURAL	r u: r @ l
RUSH	r a S
RUST	r a s t
RUT	r a t
RUTHLESS	r u: T l @ s
S	E s
SA	s a: U T @ s t r EI l j @
SABBATH	s A b @ T
SABINVACCINE	s EI b @ n v A k s i: n
SABOTAGE	s A b @ t a: Z
SACCHARIN	s A k @ r @ n
SACHET	s A S EI
SACK	s A k
SACRAMENT	s A k r @ m @ n t
SACRED	s EI k r @ d
SACRIFICE	s A k r @ f a: I s
SACRILEGE	s A k r @ l I dZ
SAD	s A d
SADDLE	s A d @ l
SAFARI	s @ f a: r i:
SAFE	s EI f
SAG	s A g
SAGA	s a: g @
SAGE	s EI dZ
SAID	s E d
SAIL	s EI l
SAILOR	s EI l @
SAINT	s EI n t
SAKE	s EI k
SALAD	s A l @ d
SALAMI	s @ l a: m i:
SALARY	s A l @ r i:
SALE	s EI l
SALESTAX	s EI l z t A k s
SALESPERSON	s EI l z p @: s @ n
SALINE	s EI l a: I n
SALIVA	s @ l a: I v @
SALLOW	s A l @U
SALON	s A l O n
SALOON	s @ l u: n
SALT	s O l t
SALUTE	s @ l u: t
SALVAGE	s A l v I dZ
SALVATION	s A l v EI S @ n
SAME	s EI m
SAMPLE	s A m p @ l
SANATORIUM	s A n @ t o: r i: @ m
SANCTION	s A N k S @ n
SAND	s A n d
SANDAL	s A n d @ l
SANDPAPER	s A n d p EI p @
SANDWICH	s A n w I tS
SANDY	s A n d i:
SANE	s EI n
SANG	s A N
SANITARY	s A n @ t r i:
SANK	s A N k
SAP	s A p
SAPPHIRE	s A f a: I@
SARCASM	s a: k A z @ m
SARDINE	s a: d i: n
SARI	s a: r i:
SARONG	s @ r O N
SASH	s A S
SAT	s A t
SATCHEL	s A tS @ l
SATELLITE	s A t @ l a: I t
SATIN	s A t @ n
SATIRE	s A t a: I@
SATISFACTORY	s A t @ s f A k t r i:
SATISFY	s A t @ s f a: I
SATURATE	s A tS @ r EI t
SATURDAY	s A t @ d EI
SAUCE	s o: s
SAUCEPAN	s o: s p @ n
SAUCER	s o: s @
SAUNA	s o: n @
SAUNTER	s o: n t @
SAUSAGE	s O s I dZ
SAUTE	s o: t EI
SAUTE	s @U t EI
SAVAGE	s A v I dZ
SAVE	s EI v
SAVIOUR	s EI v j @
SAVOUR	s EI v @
SAVOURY	s EI v @ r i:
SAW	s o:
SAY	s EI
SCAB	s k A b
SCAFFOLD	s k A f @U l d
SCAFFOLDING	s k A f @ l d I N
SCALD	s k o: l d
SCALE	s k EI l
SCALLOP	s k O l @ p
SCALP	s k A l p
SCALPEL	s k A l p @ l
SCAM	s k A m
SCAMP	s k A m p
SCAMPER	s k A m p @
SCAN	s k A n
SCANDAL	s k A n d @ l
SCANDINAVIAN	s k A n d @ n EI v i: @ n
SCANT	s k A n t
SCAPEGOAT	s k EI p g @U t
SCAR	s k a:
SCARCE	s k E@ s
SCARCELY	s k E@ s l i:
SCARE	s k E@
SCARECROW	s k E@ k r @U
SCARED	s k E@ d
SCARF	s k a: f
SCARLET	s k a: l @ t
SCARLETFEVER	s k a: l @ t f i: v @
SCARY	s k E@ r i:
SCATHING	s k EI D I N
SCATTER	s k A t @
SCATTERBRAIN	s k A t @ b r EI n
SCATTY	s k A t i:
SCAVENGE	s k A v @ n dZ
SCENE	s i: n
SCENERY	s i: n @ r i:
SCENT	s E n t
SCEPTICAL	s k E p t I k @ l
SCHEDULE	S E dZ u: l
SCHEME	s k i: m
SCHOLAR	s k O l @
SCHOLARSHIP	s k O l @ S I p
SCHOOL	s k u: l
SCHOONER	s k u: n @
SCIENCE	s a: I@ n s
SCIENTIST	s a: I@ n t @ s t
SCISSORS	s I z @ z
SCOFF	s k O f
SCOLD	s k @U l d
SCONE	s k O n
SCOOP	s k u: p
SCOOTER	s k u: t @
SCOPE	s k @U p
SCORCH	s k o: tS
SCORE	s k o:
SCORN	s k o: n
SCOT-FREE	s k O t f r i:
SCOTCH	s k O tS
SCOTTISH	s k O t I S
SCOUNDREL	s k a: U n d r @ l
SCOUT	s k a: U t
SCOWL	s k a: U l
SCRABBLE	s k r A b @ l
SCRAGGY	s k r A g i:
SCRAMBLE	s k r A m b @ l
SCRAP	s k r A p
SCRAPE	s k r EI p
SCRATCH	s k r A tS
SCRAWL	s k r o: l
SCREAM	s k r i: m
SCREECH	s k r i: tS
SCREEN	s k r i: n
SCREW	s k r u:
SCREWDRIVER	s k r u: d r a: I v @
SCRIBBLE	s k r I b @ l
SCRIMP	s k r I m p
SCRIPT	s k r I p t
SCRIPTURE	s k r I p tS @
SCROLL	s k r @U l
SCROTUM	s k r @U t @ m
SCROUNGE	s k r a: U n dZ
SCRUB	s k r a b
SCRUFF	s k r a f
SCRUFFY	s k r a f i:
SCRUM	s k r a m
SCRUPULOUS	s k r u: p j @ l @ s
SCRUTINISE	s k r u: t @ n a: I z
SCUBADIVING	s k u: b @ d a: I v I N
SCUFF	s k a f
SCUFFLE	s k a f @ l
SCULLERY	s k a l @ r i:
SCULPTURE	s k a l p tS @
SCUM	s k a m
SCURRY	s k a r i:
SCUTTLE	s k a t @ l
SEA	s i:
SEAFOOD	s i: f u: d
SEAGULL	s i: g a l
SEAL	s i: l
SEAM	s i: m
SEANCE	s EI O n s
SEARCH	s @: tS
SEASHORE	s i: S o:
SEASICKNESS	s i: s I k n @ s
SEASIDE	s i: s a: I d
SEASON	s i: z @ n
SEASONAL	s i: z @ n @ l
SEAT	s i: t
SEC	s E k
SECATEURS	s E k @ t @ z
SECOND	s E k @ n d
SECOND-CLASS	s E k @ n d k l a: s
SECOND-HAND	s E k @ n d h A n d
SECOND-RATE	s E k @ n d r EI t
SECONDARY	s E k @ n d r i:
SECRET	s i: k r @ t
SECRETARY	s E k r @ t r i:
SECRETE	s @ k r i: t
SECT	s E k t
SECTION	s E k S @ n
SECTOR	s E k t @
SECULAR	s E k j @ l @
SECURE	s @ k j u: @
SECURITY	s @ k j u: r @ t i:
SEDAN	s @ d A n
SEDATE	s @ d EI t
SEDATIVE	s E d @ t I v
SEDIMENT	s E d @ m @ n t
SEDUCE	s @ d j u: s
SEE	s i:
SEED	s i: d
SEEDLING	s i: d l I N
SEEDY	s i: d i:
SEEK	s i: k
SEEM	s i: m
SEEP	s i: p
SEESAW	s i: s o:
SEGMENT	s E g m @ n t
SEGREGATE	s E g r @ g EI t
SEIZE	s i: z
SELDOM	s E l d @ m
SELECT	s @ l E k t
SELECTIVE	s @ l E k t I v
SELF	s E l f
SELF-CENTRED	s E l f s E n t @ d
SELF-CONFIDENT	s E l f k O n f @ d @ n s
SELF-CONSCIOUS	s E l f k O n S @ s
SELF-DEFENCE	s E l f d @ f E n s
SELF-SERVICE	s E l f s @: v @ s
SELFISH	s E l f I S
SELL	s E l
SEMEN	s i: m @ n
SEMESTER	s @ m E s t @
SEMI-CONSCIOUS	s E m i: k O n S @ s
SEMI-DETACHED	s E m i: d @ t A tS t
SEMICOLON	s E m i: k @U l @ n
SEMINAR	s E m @ n a:
SEMINARY	s E m @ n r i:
SEMITRAILER	s E m i: t r EI l @
SENATE	s E n @ t
SENATOR	s E n @ t @
SEND	s E n d
SENILE	s E n a: I l
SENIOR	s i: n j @
SENSATION	s E n s EI S @ n
SENSATIONAL	s E n s EI S @ n @ l
SENSE	s E n s
SENSIBLE	s E n s @ b @ l
SENSITIVE	s E n s @ t I v
SENT	s E n t
SENTENCE	s E n t @ n s
SENTIMENT	s E n t @ m @ n t
SENTIMENTAL	s E n t @ m E n t @ l
SENTRY	s E n t r i:
SEPARATE	s E p r @ t
SEPT	s @ p t E m b @
SEPTEMBER	s @ p t E m b @
SEPTIC	s E p t I k
SEPTICTANK	s E p t I k t A N k
SEQUEL	s i: k w @ l
SEQUENCE	s i: k w @ n s
SERBIAN	s @: b i: @ n
SERENE	s @ r i: n
SERGEANT	s a: dZ @ n t
SERIAL	s I@ r i: @ l
SERIES	s I@ r i: z
SERIOUS	s I@ r i: @ s
SERMON	s @: m @ n
SERPENT	s @: p @ n t
SERRATED	s @ r EI t @ d
SERUM	s I@ r @ m
SERVANT	s @: v @ n t
SERVE	s @: v
SERVICE	s @: v @ s
SERVICESTATION	s @: v @ s s t EI S @ n
SERVICEABLE	s @: v @ s @ b @ l
SERVIETTE	s @: v i: E t
SERVING	s @: v I N
SERVINGSPOON	s @: v I N s p u: n
SESSION	s E S @ n
SET	s E t
SET-UP	s E t a p
SETBACK	s E t b A k
SETTEE	s E t i:
SETTING	s E t I N
SETTLE	s E t @ l
SEVEN	s E v @ n
SEVENTEEN	s E v @ n t i: n
SEVENTEENTH	s E v @ n t i: n T
SEVENTH	s E v @ n T
SEVENTIES	s E v @ n t i: z
SEVENTY	s E v @ n t i:
SEVER	s E v @
SEVERAL	s E v r @ l
SEVERANCEPAY	s E v r @ n s p EI
SEVERE	s @ v I@
SEW	s @U
SEWAGE	s u: I dZ
SEWER	s u: @
SEWERAGE	s u: @ r I dZ
SEWINGMACHINE	s @U I N m @ S i: n
SEX	s E k s
SEXISM	s E k s I z @ m
SEXY	s E k s i:
SHABBY	S A b i:
SHACK	S A k
SHADE	S EI d
SHADOW	S A d @U
SHAGGY	S A g i:
SHAKE	S EI k
SHAKE-UP	S EI k a p
SHALL	S A l
SHALLOW	S A l @U
SHAM	S A m
SHAME	S EI m
SHAMPOO	S A m p u:
SHANDY	S A n d i:
SHANT	S a: n t
SHANTY	S A n t i:
SHAPE	S EI p
SHARE	S E@
SHAREHOLDER	S E@ h @U l d @
SHARK	S a: k
SHARP	S a: p
SHARPENER	S a: p n @
SHATTER	S A t @
SHAVE	S EI v
SHAW	S o:
SHAWL	S o: l
SHEAR	S I@
SHED	S E d
SHEEP	S i: p
SHEEPISH	S i: p I S
SHEER	S I@
SHEET	S i: t
SHELF	S E l f
SHELL	S E l
SHELLFISH	S E l f I S
SHELTER	S E l t @
SHELVE	S E l v
SHELVING	S E l v I N
SHIELD	S i: l d
SHIFT	S I f t
SHIFTY	S I f t i:
SHIMMER	S I m @
SHIN	S I n
SHINE	S a: I n
SHINGLE	S I N g @ l
SHIP	S I p
SHIPMENT	S I p m @ n t
SHIPSHAPE	S I p S EI p
SHIRK	S @: k
SHIRT	S @: t
SHISHKEBAB	S I S k @ b A b
SHIT	S I t
SHIVER	S I v @
SHOCK	S O k
SHODDY	S O d i:
SHOE	S u:
SHONE	S O n
SHOOK	S U k
SHOOT	S u: t
SHOP	S O p
SHOPASSISTANT	S O p @ s I s t @ n t
SHOPSTEWARD	S O p s t j u: @ d
SHOPKEEPER	S O p k i: p @
SHOPLIFT	S O p l I f t
SHORE	S o:
SHORN	S o: n
SHORT	S o: t
SHORT-SIGHTED	S o: t s a: I t @ d
SHORT-TEMPERED	S o: t t E m p @ d
SHORTAGE	S o: t I dZ
SHORTCOMING	S o: t k a m I N
SHORTCUT	S o: t k a t
SHORTEN	S o: t @ n
SHORTHAND	S o: t h A n d
SHORTLY	S o: t l i:
SHOT	S O t
SHOTGUN	S O t g a n
SHOULD	S U d
SHOULDER	S @U l d @
SHOUT	S a: U t
SHOVE	S a v
SHOVEL	S a v @ l
SHOW	S @U
SHOW-OFF	S @U O f
SHOWDOWN	S @U d a: U n
SHOWER	S a: U@
SHOWY	S @U i:
SHRED	S r E d
SHREWD	S r u: d
SHRIEK	S r i: k
SHRILL	S r I l
SHRIMP	S r I m p
SHRINK	S r I N k
SHRIVEL	S r I v @ l
SHRUB	S r a b
SHRUG	S r a g
SHUDDER	S a d @
SHUFFLE	S a f @ l
SHUN	S a n
SHUT	S a t
SHUTTER	S a t @
SHY	S a: I
SIBLING	s I b l I N
SICK	s I k
SICKEN	s I k @ n
SICKENING	s I k @ n I N
SICKIE	s I k i:
SICKLY	s I k l i:
SICKNESS	s I k n @ s
SIDE	s a: I d
SIDE-EFFECTS	s a: I d @ f E k t s
SIDESHOW	s a: I d S @U
SIDEWAYS	s a: I d w EI z
SIEGE	s i: dZ
SIESTA	s i: E s t @
SIEVE	s I v
SIFT	s I f t
SIGH	s a: I
SIGHT	s a: I t
SIGHTSEEING	s a: I t s i: I N
SIGN	s a: I n
SIGNAL	s I g n @ l
SIGNATURE	s I g n @ tS @
SIGNIFICANT	s I g n I f @ k @ n t
SILENCE	s a: I l @ n s
SILK	s I l k
SILKWORM	s I l k w @: m
SILL	s I l
SILLY	s I l i:
SILVER	s I l v @
SIMILAR	s I m @ l @
SIMMER	s I m @
SIMPLE	s I m p @ l
SIMPLE-MINDED	s I m p @ l m a: I n d @ d
SIMPLY	s I m p l i:
SIMULTANEOUS	s I m @ l t EI n i: @ s
SIN	s I n
SINCE	s I n s
SINCERE	s I n s I@
SINCERELY	s I n s I@ l i:
SING	s I N
SINGE	s I n dZ
SINGLE	s I N g @ l
SINGLE-HANDED	s I N g @ l h A n d @ d
SINGLE-MINDED	s I N g @ l m a: I n d @ d
SINGLET	s I N l @ t
SINGSONG	s I N s O N
SINGULAR	s I N g j @ l @
SINISTER	s I n @ s t @
SINK	s I N k
SINKER	s I N k @
SINUS	s a: I n @ s
SINUSITIS	s a: I n @ s a: I t @ s
SIP	s I p
SIR	s @:
SIREN	s a: I r @ n
SISSY	s I s i:
SISTER	s I s t @
SISTER-IN-LAW	s I s t @ r I n l o:
SIT	s I t
SIT-IN	s I t I n
SITCOM	s I t k O m
SITE	s a: I t
SITTER	s I t @
SITTINGROOM	s I t I N r u: m
SITUATED	s I tS u: EI t @ d
SITUATION	s I tS u: EI S @ n
SIX	s I k s
SIXTEEN	s I k s t i: n
SIXTEENTH	s I k s t i: n T
SIXTH	s I k s T
SIXTY	s I k s t i:
SIZE	s a: I z
SIZEABLE	s a: I z @ b @ l
SIZZLE	s I z @ l
SKATE	s k EI t
SKEIN	s k EI n
SKELETON	s k E l @ t @ n
SKETCH	s k E tS
SKETCHY	s k E tS i:
SKEWER	s k j u: @
SKI	s k i:
SKID	s k I d
SKILFUL	s k I l f @ l
SKILL	s k I l
SKIM	s k I m
SKIMP	s k I m p
SKIMPY	s k I m p i:
SKIN	s k I n
SKINNY	s k I n i:
SKIP	s k I p
SKIRT	s k @: t
SKIVVY	s k I v i:
SKULL	s k a l
SKY	s k a: I
SKYSCRAPER	s k a: I s k r EI p @
SLAB	s l A b
SLACK	s l A k
SLACKEN	s l A k @ n
SLAM	s l A m
SLAMMER	s l A m @
SLANDER	s l A n d @
SLANG	s l A N
SLANT	s l A n t
SLAP	s l A p
SLAPDASH	s l A p d A S
SLAPSTICK	s l A p s t I k
SLASH	s l A S
SLAT	s l A t
SLATE	s l EI t
SLAUGHTER	s l o: t @
SLAVE	s l EI v
SLAY	s l EI
SLEAZY	s l i: z i:
SLEDGE	s l E dZ
SLEDGEHAMMER	s l E dZ h A m @
SLEEK	s l i: k
SLEEP	s l i: p
SLEEVE	s l i: v
SLENDER	s l E n d @
SLICE	s l a: I s
SLICK	s l I k
SLIDE	s l a: I d
SLIGHT	s l a: I t
SLIM	s l I m
SLIME	s l a: I m
SLING	s l I N
SLINK	s l I N k
SLINKY	s l I N k i:
SLIP	s l I p
SLIPPERS	s l I p @ z
SLIPPERY	s l I p r i:
SLIPPERY	s l I p @ r i:
SLIPPERYDIP	s l I p r i: d I p
SLIT	s l I t
SLOB	s l O b
SLOBBER	s l O b @
SLOG	s l O g
SLOGAN	s l @U g @ n
SLOP	s l O p
SLOPE	s l @U p
SLOPPY	s l O p i:
SLOPPYJOE	s l O p i: dZ @U
SLOSH	s l O S
SLOSHED	s l O S t
SLOT	s l O t
SLOUCH	s l a: U tS
SLOVENLY	s l a v @ n l i:
SLOW	s l @U
SLUDGE	s l a dZ
SLUG	s l a g
SLUGGISH	s l a g I S
SLUM	s l a m
SLUMP	s l a m p
SLUNG	s l a N
SLUR	s l @:
SLURP	s l @: p
SLUSH	s l a S
SLUT	s l a t
SLY	s l a: I
SMACK	s m A k
SMALL	s m o: l
SMALLGOODS	s m o: l g U d z
SMALLPOX	s m o: l p O k s
SMART	s m a: t
SMASH	s m A S
SMEAR	s m I@
SMELL	s m E l
SMELT	s m E l t
SMELTER	s m E l t @
SMILE	s m a: I l
SMIRK	s m @: k
SMITHEREENS	s m I D @ r i: n z
SMOG	s m O g
SMOKE	s m @U k
SMOKESCREEN	s m @U k s k r i: n
SMOOTH	s m u: D
SMORGASBORD	s m o: g @ s b o: d
SMOTHER	s m a D @
SMOULDER	s m @U l d @
SMUDGE	s m a dZ
SMUG	s m a g
SMUGGLE	s m a g @ l
SNACK	s n A k
SNAG	s n A g
SNAIL	s n EI l
SNAKE	s n EI k
SNAP	s n A p
SNAPPY	s n A p i:
SNAPSHOT	s n A p S O t
SNARL	s n a: l
SNATCH	s n A tS
SNEAK	s n i: k
SNEER	s n I@
SNEEZE	s n i: z
SNIFF	s n I f
SNIFFLE	s n I f @ l
SNIGGER	s n I g @
SNIP	s n I p
SNIPE	s n a: I p
SNIVEL	s n I v @ l
SNOB	s n O b
SNOOKER	s n u: k @
SNOOP	s n u: p
SNOOTY	s n u: t i:
SNOOZE	s n u: z
SNORE	s n o:
SNORKEL	s n o: k @ l
SNORT	s n o: t
SNOUT	s n a: U t
SNOW	s n @U
SNUB	s n a b
SNUG	s n a g
SNUGGLE	s n a g @ l
SO	s @U
SO-AND-SO	s @U @ n s @U
SOAK	s @U k
SOAP	s @U p
SOAR	s o:
SOB	s O b
SOBER	s @U b @
SOCCER	s O k @
SOCIAL	s @U S @ l
SOCIALSECURITY	s @U S @ l s @ k j u: r @ t i:
SOCIALISE	s @U S @ l a: I z
SOCIALISM	s @U S @ l I z @ m
SOCIETY	s @ s a: I@ t i:
SOCIOLOGY	s @U s i: O l @ dZ i:
SOCK	s O k
SOCKET	s O k @ t
SODA	s @U d @
SODIUM	s @U d i: @ m
SODIUMBICARBONATE	s @U d i: @ m b a: I k a: b @ n @ t
SOFA	s @U f @
SOFABED	s @U f @ b E d
SOFT	s O f t
SOGGY	s O g i:
SOIL	s o: I l
SOLAR	s @U l @
SOLD	s @U l d
SOLDIER	s @U l dZ @
SOLE	s @U l
SOLEMN	s O l @ m
SOLICITOR	s @ l I s @ t @
SOLID	s O l @ d
SOLITARY	s O l @ t r i:
SOLO	s @U l @U
SOLOIST	s @U l @U @ s t
SOLUBLE	s O l j @ b @ l
SOLUTION	s @ l u: S @ n
SOLVE	s O l v
SOMBRE	s O m b @
SOME	s a m
SOMEBODY	s a m b O d i:
SOMEHOW	s a m h a: U
SOMEONE	s a m w a n
SOMERSAULT	s a m @ s O l t
SOMETHING	s a m T I N
SOMETIME	s a m t a: I m
SOMETIMES	s a m t a: I m z
SOMEWHERE	s a m w E@
SON	s a n
SON-IN-LAW	s a n I n l o:
SONG	s O N
SOON	s u: n
SOOT	s U t
SOOTHE	s u: D
SOPHISTICATED	s @ f I s t @ k EI t @ d
SOPPING	s O p I N
SOPRANO	s @ p r a: n @U
SORBET	s o: b EI
SORDID	s o: d @ d
SORE	s o:
SORROW	s O r @U
SORRY	s O r i:
SORT	s o: t
SOUFFLE	s u: f l EI
SOUGHT	s o: t
SOUL	s @U l
SOUND	s a: U n d
SOUP	s u: p
SOUR	s a: U@
SOURCE	s o: s
SOUTH	s a: U T
SOUTHERNCROSS	s a D @ n k r O s
SOUVENIR	s u: v @ n I@
SOVIET	s @U v i: @ t
SOW	s @U
SOW	s a: U
SOYABEAN	s o: I@ b i: n
SOYASAUCE	s o: I@ s o: s
SPA	s p a:
SPACE	s p EI s
SPACECRAFT	s p EI s k r a: f t
SPACIOUS	s p EI S @ s
SPADE	s p EI d
SPAGHETTI	s p @ g E t i:
SPAN	s p A n
SPANISH	s p A n I S
SPANK	s p A N k
SPANNER	s p A n @
SPARE	s p E@
SPARK	s p a: k
SPARKPLUG	s p a: k p l a g
SPARKLE	s p a: k @ l
SPARSE	s p a: s
SPASM	s p A z @ m
SPASMODIC	s p A z m O d I k
SPASTIC	s p A s t I k
SPEAK	s p i: k
SPEAKER	s p i: k @
SPEAR	s p I@
SPECIAL	s p E S @ l
SPECIALISE	s p E S @ l a: I z
SPECIALISED	s p E S @ l a: I z d
SPECIALIST	s p E S @ l @ s t
SPECIALLY	s p E S @ l i:
SPECIES	s p i: s i: z
SPECIFIC	s p @ s I f I k
SPECIFICATION	s p E s @ f @ k EI S @ n
SPECIFY	s p E s @ f a: I
SPECIMEN	s p E s @ m @ n
SPECK	s p E k
SPECTACLE	s p E k t @ k @ l
SPECTACLES	s p E k t @ k @ l z
SPECTACULAR	s p E k t A k j @ l @
SPECTATOR	s p E k t EI t @
SPECTRUM	s p E k t r @ m
SPECULATE	s p E k j @ l EI t
SPED	s p E d
SPEECH	s p i: tS
SPEED	s p i: d
SPEEDOMETER	s p i: d O m @ t @
SPELL	s p E l
SPELT	s p E l t
SPENCER	s p E n s @
SPEND	s p E n d
SPENDTHRIFT	s p E n d T r I f t
SPERM	s p @: m
SPEW	s p j u:
SPHERE	s f I@
SPICE	s p a: I s
SPIDER	s p a: I d @
SPIKE	s p a: I k
SPIKY	s p a: I k i:
SPILL	s p I l
SPIN	s p I n
SPINDRIER	s p I n d r a: I@
SPIN-DRY	s p I n d r a: I
SPINE	s p a: I n
SPINELESS	s p a: I n l @ s
SPINNAKER	s p I n @ k @
SPINNINGWHEEL	s p I n I N w i: l
SPINSTER	s p I n s t @
SPINY	s p a: I n i:
SPINYANTEATER	s p a: I n i: A n t i: t @
SPIRAL	s p a: I r @ l
SPIRE	s p a: I@
SPIRIT	s p I r @ t
SPIRITUAL	s p I r @ tS @ l
SPIT	s p I t
SPITE	s p a: I t
SPITEFUL	s p a: I t f U l
SPLASH	s p l A S
SPLATTER	s p l A t @
SPLEEN	s p l i: n
SPLENDID	s p l E n d @ d
SPLINT	s p l I n t
SPLINTER	s p l I n t @
SPLIT	s p l I t
SPLIT-LEVEL	s p l I t l E v @ l
SPLUTTER	s p l a t @
SPOIL	s p o: I l
SPOKE	s p @U k
SPOKEN	s p @U k @ n
SPOKESPERSON	s p @U k s p @: s @ n
SPONGE	s p a n dZ
SPONSOR	s p O n s @
SPONSORSHIP	s p O n s @ S I p
SPONTANEOUS	s p O n t EI n i: @ s
SPOOK	s p u: k
SPOOKY	s p u: k i:
SPOON	s p u: n
SPORADIC	s p @ r A d I k
SPORT	s p o: t
SPORTS	s p o: t s
SPOT	s p O t
SPOTLESS	s p O t l @ s
SPOTTED	s p O t @ d
SPOTTY	s p O t i:
SPOUSE	s p a: U s
SPOUT	s p a: U t
SPRAIN	s p r EI n
SPRANG	s p r A N
SPRAWL	s p r o: l
SPRAY	s p r EI
SPREAD	s p r E d
SPREE	s p r i:
SPRING	s p r I N
SPRING-CLEAN	s p r I N k l i: n
SPRINKLE	s p r I N k @ l
SPRINKLER	s p r I N k l @
SPRINT	s p r I n t
SPROUT	s p r a: U t
SPROUTS	s p r a: U t s
SPRUNG	s p r a N
SPUD	s p a d
SPUN	s p a n
SPUR	s p @:
SPURT	s p @: t
SPY	s p a: I
SQUABBLE	s k w O b @ l
SQUAD	s k w O d
SQUALID	s k w O l @ d
SQUANDER	s k w O n d @
SQUARE	s k w E@
SQUASH	s k w O S
SQUEAK	s k w i: k
SQUEAL	s k w i: l
SQUEEZE	s k w i: z
SQUINT	s k w I n t
SQUIRM	s k w @: m
SQUIRT	s k w @: t
STAB	s t A b
STABLE	s t EI b @ l
STACK	s t A k
STADIUM	s t EI d i: @ m
STAFF	s t a: f
STAGE	s t EI dZ
STAGGER	s t A g @
STAGNANT	s t A g n @ n t
STAIN	s t EI n
STAIR	s t E@
STAIRCASE	s t E@ k EI s
STAKE	s t EI k
STALE	s t EI l
STALK	s t o: k
STALL	s t o: l
STAMINA	s t A m @ n @
STAMMER	s t A m @
STAMP	s t A m p
STAMPDUTY	s t A m p d j u: t i:
STAMPEDE	s t A m p i: d
STAND	s t A n d
STAND-BY	s t A n d b a: I
STANDARD	s t A n d @ d
STANDING	s t A n d I N
STANDSTILL	s t A n d s t I l
STAPLE	s t EI p @ l
STAPLER	s t EI p l @
STAR	s t a:
STARCH	s t a: tS
STARE	s t E@
STARK	s t a: k
START	s t a: t
STARTLE	s t a: t @ l
STARVE	s t a: v
STATE	s t EI t
STATEMENT	s t EI t m @ n t
STATIC	s t A t I k
STATION	s t EI S @ n
STATIONWAGON	s t EI S @ n w A g @ n
STATIONARY	s t EI S @ n r i:
STATIONERY	s t EI S @ n r i:
STATISTICS	s t @ t I s t I k s
STATUE	s t A tS u:
STATUS	s t EI t @ s
STATUTE	s t A tS u: t
STATUTORYDECLARATION	s t A tS @ t r i: d E k l @ r EI S @ n
STAY	s t EI
STD	E s t i: d i:
STEADFAST	s t E d f a: s t
STEADY	s t E d i:
STEAK	s t EI k
STEAL	s t i: l
STEAM	s t i: m
STEEL	s t i: l
STEEP	s t i: p
STEEPLE	s t i: p @ l
STEER	s t I@
STEERINGWHEEL	s t I@ r I N w i: l
STEM	s t E m
STENOGRAPHER	s t @ n O g r @ f @
STEP	s t E p
STEPFATHER	s t E p f a: D @
STEPLADDER	s t E p l A d @
STEPMOTHER	s t E p m a D @
STEREO	s t E r i: @U
STERILE	s t E r a: I l
STERILISE	s t E r @ l a: I z
STERN	s t @: n
STETHOSCOPE	s t E T @ s k @U p
STEW	s t j u:
STEWARD	s t j u: @ d
STICK	s t I k
STICKER	s t I k @
STICKY	s t I k i:
STIFF	s t I f
STIGMA	s t I g m @
STILL	s t I l
STIMULANT	s t I m j @ l @ n t
STIMULATE	s t I m j @ l EI t
STING	s t I N
STINGY	s t I n dZ i:
STINK	s t I N k
STIR	s t @:
STITCH	s t I tS
STOCK	s t O k
STOCKEXCHANGE	s t O k E k s tS EI n dZ
STOCKING	s t O k I N
STOCKMAN	s t O k m @ n
STOCKY	s t O k i:
STOLE	s t @U l
STOLEN	s t @U l @ n
STOMACH	s t a m @ k
STONE	s t @U n
STONE-COLD	s t @U n k @U l d
STOOD	s t U d
STOOL	s t u: l
STOOP	s t u: p
STOP	s t O p
STOPOVER	s t O p @U v @
STOPPER	s t O p @
STORAGE	s t o: r I dZ
STORE	s t o:
STOREY	s t o: r i:
STORM	s t o: m
STORY	s t o: r i:
STOUT	s t a: U t
STOVE	s t @U v
STRAGGLE	s t r A g @ l
STRAIGHT	s t r EI t
STRAIGHTAWAY	s t r EI t @ w EI
STRAIGHTFORWARD	s t r EI t f o: w @ d
STRAIN	s t r EI n
STRAINED	s t r EI n d
STRAND	s t r A n d
STRANGE	s t r EI n dZ
STRANGER	s t r EI n dZ @
STRANGLE	s t r A N g @ l
STRAP	s t r A p
STRATEGIC	s t r @ t i: dZ I k
STRATEGY	s t r A t @ dZ i:
STRAW	s t r o:
STRAY	s t r EI
STREAK	s t r i: k
STREAM	s t r i: m
STREAMER	s t r i: m @
STREET	s t r i: t
STRENGTH	s t r E N k T
STRENGTH	s t r E N T
STRENUOUS	s t r E n j u: @ s
STRESS	s t r E s
STRETCH	s t r E tS
STRICKEN	s t r I k @ n
STRICT	s t r I k t
STRIDE	s t r a: I d
STRIFE	s t r a: I f
STRIKE	s t r a: I k
STRIKING	s t r a: I k I N
STRING	s t r I N
STRIP	s t r I p
STRIPE	s t r a: I p
STRIPPER	s t r I p @
STRIVE	s t r a: I v
STRODE	s t r @U d
STROKE	s t r @U k
STROLL	s t r @U l
STROLLER	s t r @U l @
STRONG	s t r O N
STROVE	s t r @U v
STRUCK	s t r a k
STRUCTURE	s t r a k tS @
STRUGGLE	s t r a g @ l
STUB	s t a b
STUBBORN	s t a b @ n
STUBBY	s t a b i:
STUCK	s t a k
STUCK-UP	s t a k a p
STUDENT	s t j u: d @ n t
STUDIO	s t j u: d i: @U
STUDY	s t a d i:
STUFF	s t a f
STUFFING	s t a f I N
STUFFY	s t a f i:
STUMBLE	s t a m b @ l
STUMP	s t a m p
STUMPY	s t a m p i:
STUN	s t a n
STUNG	s t a N
STUNNING	s t a n I N
STUPID	s t j u: p @ d
STURDY	s t @: d i:
STUTTER	s t a t @
STYLE	s t a: I l
STYLISH	s t a: I l I S
SUBDIVIDE	s a b d @ v a: I d
SUBDUE	s @ b d j u:
SUBDUED	s @ b d j u: d
SUBJECT	s a b dZ E k t
SUBMARINE	s a b m @ r i: n
SUBMERGE	s @ b m @: dZ
SUBMIT	s @ b m I t
SUBORDINATE	s @ b o: d @ n @ t
SUBSCRIBE	s @ b s k r a: I b
SUBSCRIBER	s @ b s k r a: I b @
SUBSCRIPTION	s @ b s k r I p S @ n
SUBSEQUENT	s a b s @ k w @ n t
SUBSIDE	s @ b s a: I d
SUBSIDIARY	s @ b s I dZ @ r i:
SUBSIDY	s a b s @ d i:
SUBSTANCE	s a b s t @ n s
SUBSTANTIAL	s @ b s t A n S @ l
SUBSTITUTE	s a b s t @ tS u: t
SUBTITLE	s a b t a: I t @ l
SUBTLE	s a t @ l
SUBTRACT	s @ b t r A k t
SUBURB	s a b @: b
SUBURBIA	s @ b @: b i: @
SUCCEED	s @ k s i: d
SUCCESS	s @ k s E s
SUCH	s a tS
SUCK	s a k
SUDDEN	s a d @ n
SUDS	s a d z
SUE	s u:
SUEDE	s w EI d
SUFFER	s a f @
SUFFERING	s a f @ r I N
SUFFICIENT	s @ f I S @ n t
SUFFIX	s a f I k s
SUFFOCATE	s a f @ k EI t
SUGAR	S U g @
SUGGEST	s @ dZ E s t
SUICIDAL	s u: @ s a: I d @ l
SUICIDE	s u: @ s a: I d
SUIT	s u: t
SUITABLE	s u: t @ b @ l
SUITCASE	s u: t k EI s
SUITE	s w i: t
SUITED	s u: t @ d
SULK	s a l k
SULLEN	s a l @ n
SULTANA	s a l t a: n @
SULTRY	s a l t r i:
SUM	s a m
SUMMARY	s a m @ r i:
SUMMER	s a m @
SUMMIT	s a m @ t
SUMMON	s a m @ n
SUMMONS	s a m @ n z
SUMPTUOUS	s a m p tS u: @ s
SUN	s a n
SUNBAKE	s a n b EI k
SUNBURN	s a n b @: n
SUNDAY	s a n d EI
SUNDRY	s a n d r i:
SUNG	s a N
SUNGLASSES	s a n g l a: s @ z
SUNK	s a N k
SUNKEN	s a N k @ n
SUNLIGHT	s a n l a: I t
SUNNY	s a n i:
SUNRISE	s a n r a: I z
SUNSCREEN	s a n s k r i: n
SUNSET	s a n s E t
SUNSHINE	s a n S a: I n
SUNSTROKE	s a n s t r @U k
SUNTAN	s a n t A n
SUPER	s u: p @
SUPERANNUATION	s u: p @ r A n j u: EI S @ n
SUPERB	s @ p @: b
SUPERFICIAL	s u: p @ f I S @ l
SUPERINTENDENT	s u: p @ r I n t E n d @ n t
SUPERIOR	s @ p I@ r i: @
SUPERLATIVE	s @ p @: l @ t I v
SUPERMARKET	s u: p @ m a: k @ t
SUPERSTITIOUS	s u: p @ s t I S @ s
SUPERVISE	s u: p @ v a: I z
SUPPER	s a p @
SUPPLE	s a p @ l
SUPPLEMENT	s a p l @ m @ n t
SUPPLY	s @ p l a: I
SUPPORT	s @ p o: t
SUPPORTIVE	s @ p o: t I v
SUPPOSE	s @ p @U z
SUPPOSED	s @ p @U z d
SUPPRESS	s @ p r E s
SUPREME	s @ p r i: m
SURE	S o:
SURELY	S o: l i:
SURF	s @: f
SURFACE	s @: f @ s
SURFBOARD	s @: f b o: d
SURGE	s @: dZ
SURGEON	s @: dZ @ n
SURGERY	s @: dZ @ r i:
SURLY	s @: l i:
SURNAME	s @: n EI m
SURPASS	s @ p a: s
SURPLUS	s @: p l @ s
SURPRISE	s @ p r a: I z
SURRENDER	s @ r E n d @
SURROUND	s @ r a: U n d
SURROUNDINGS	s @ r a: U n d I N z
SURVEY	s @: v EI
SURVEY	s @ v EI
SURVEYOR	s @ v EI @
SURVIVE	s @ v a: I v
SUSPECT	s @ s p E k t
SUSPEND	s @ s p E n d
SUSPENSE	s @ s p E n s
SUSPENSION	s @ s p E n S @ n
SUSPICION	s @ s p I S @ n
SUSPICIOUS	s @ s p I S @ s
SUSS	s a s
SUSTAIN	s @ s t EI n
SWAG	s w A g
SWAGGER	s w A g @
SWALLOW	s w O l @U
SWAM	s w A m
SWAMP	s w O m p
SWAP	s w O p
SWARM	s w o: m
SWARTHY	s w o: D i:
SWAT	s w O t
SWAY	s w EI
SWEAR	s w E@
SWEAT	s w E t
SWEATER	s w E t @
SWEEP	s w i: p
SWEEPING	s w i: p I N
SWEET	s w i: t
SWEETEN	s w i: t @ n
SWEETHEART	s w i: t h a: t
SWELL	s w E l
SWELLING	s w E l I N
SWEPT	s w E p t
SWERVE	s w @: v
SWIFT	s w I f t
SWIM	s w I m
SWIMMERS	s w I m @ z
SWIMMINGPOOL	s w I m I N p u: l
SWIMSUIT	s w I m s u: t
SWINDLE	s w I n d @ l
SWING	s w I N
SWIPE	s w a: I p
SWITCH	s w I tS
SWITCHBOARD	s w I tS b o: d
SWOLLEN	s w @U l @ n
SWOOP	s w u: p
SWORD	s o: d
SWORE	s w o:
SWORN	s w o: n
SWUM	s w a m
SWUNG	s w a N
SYCAMORE	s I k @ m o:
SYLLABLE	s I l @ b @ l
SYLLABUS	s I l @ b @ s
SYMBOL	s I m b @ l
SYMMETRY	s I m @ t r i:
SYMPATHY	s I m p @ T i:
SYMPHONY	s I m f @ n i:
SYMPTOM	s I m p t @ m
SYNAGOGUE	s I n @ g O g
SYNDICATE	s I n d @ k @ t
SYNDICATE	s I n d I k @ t
SYNONYM	s I n @ n I m
SYNOPSIS	s @ n O p s @ s
SYNTHETIC	s I n T E t I k
SYRINGE	s @ r I n dZ
SYRUP	s I r @ p
SYSTEM	s I s t @ m
T	t i:
T-SHIRT	t i: S @: t
TA	t a:
TAB	t A b
TABBY	t A b i:
TABLE	t EI b @ l
TABLETENNIS	t EI b @ l t E n @ s
TABLECLOTH	t EI b @ l k l O T
TABLESPOON	t EI b @ l s p u: n
TABLET	t A b l @ t
TABLEWARE	t EI b @ l w E@
TABLOID	t A b l o: I d
TABOO	t @ b u:
TABULATE	t A b j @ l EI t
TACIT	t A s @ t
TACITURN	t A s @ t @: n
TACK	t A k
TACKLE	t A k @ l
TACKY	t A k i:
TACT	t A k t
TACTIC	t A k t I k
TACTICS	t A k t I k s
TAFE	t EI f
TAG	t A g
TAIL	t EI l
TAILOR	t EI l @
TAIPAN	t a: I p A n
TAKE	t EI k
TAKE-OFF	t EI k O f
TAKEAWAY	t EI k @ w EI
TAKINGS	t EI k I N z
TALCUMPOWDER	t A l k @ m p a: U d @
TALE	t EI l
TALENT	t A l @ n t
TALK	t o: k
TALKBACK	t o: k b A k
TALL	t o: l
TALLY	t A l i:
TALON	t A l @ n
TAME	t EI m
TAMPER	t A m p @
TAMPON	t A m p O n
TAN	t A n
TANDEM	t A n d @ m
TANG	t A N
TANGENT	t A n dZ @ n t
TANGERINE	t A n dZ @ r i: n
TANGIBLE	t A n dZ @ b @ l
TANGLE	t A N g @ l
TANK	t A N k
TANKARD	t A N k @ d
TANKER	t A N k @
TANTALISE	t A n t @ l a: I z
TANTAMOUNT	t A n t @ m a: U n t
TANTRUM	t A n t r @ m
TAP	t A p
TAPE	t EI p
TAPE-RECORDER	t EI p r @ k o: d @
TAPER	t EI p @
TAPESTRY	t A p @ s t r i:
TAR	t a:
TARGET	t a: g @ t
TARIFF	t A r @ f
TARMAC	t a: m A k
TARNISH	t a: n I S
TARPAULIN	t a: p o: l @ n
TARRAGON	t A r @ g @ n
TART	t a: t
TARTAN	t a: t @ n
TAS	t A z m EI n j @
TASK	t a: s k
TASSEL	t A s @ l
TASTE	t EI s t
TASTEFUL	t EI s t f U l
TASTELESS	t EI s t l @ s
TASTY	t EI s t i:
TATTERED	t A t @ d
TATTERS	t A t @ z
TATTOO	t A t u:
TATTY	t A t i:
TAUGHT	t o: t
TAUNT	t o: n t
TAUT	t o: t
TAUTOLOGY	t o: t O l @ dZ i:
TAVERN	t A v @ n
TAWDRY	t o: d r i:
TAWNY	t o: n i:
TAX	t A k s
TAXI	t A k s i:
TEA	t i:
TEATOWEL	t i: t a: U l
TEABAG	t i: b A g
TEACH	t i: tS
TEACHER	t i: tS @
TEACHERSAIDE	t i: tS @ z EI d
TEAM	t i: m
TEAPOT	t i: p O t
TEAR	t I@
TEASE	t i: z
TEASPOON	t i: s p u: n
TEAT	t i: t
TECH	t E k
TECHNICAL	t E k n I k @ l
TECHNICALCOLLEGE	t E k n I k @ l k O l I dZ
TECHNICIAN	t E k n I S @ n
TECHNIQUE	t E k n i: k
TECHNOLOGY	t E k n O l @ dZ i:
TEDDYBEAR	t E d i: b E@
TEDIOUS	t i: d i: @ s
TEE	t i:
TEEM	t i: m
TEENAGER	t i: n EI dZ @
TEENS	t i: n z
TEETH	t i: T
TEETOTAL	t i: t @U t @ l
TELECAST	t E l @ k a: s t
TELECOMMUNICATIONS	t E l @ k @ m j u: n @ k EI S @ n z
TELEPATHY	t @ l E p @ T i:
TELEPHONE	t E l @ f @U n
TELEPHONEEXCHANGE	t E l @ f @U n E k s tS EI n dZ
TELESCOPE	t E l @ s k @U p
TELEVISION	t E l @ v I Z @ n
TELL	t E l
TELLER	t E l @
TEMPER	t E m p @
TEMPERAMENT	t E m p r @ m @ n t
TEMPERAMENTAL	t E m p r @ m E n t @ l
TEMPERATURE	t E m p r @ tS @
TEMPORARY	t E m p r i:
TEMPT	t E m p t
TEN	t E n
TENACIOUS	t @ n EI S @ s
TENANT	t E n @ n t
TEND	t E n d
TENDER	t E n d @
TENDON	t E n d @ n
TENEMENT	t E n @ m @ n t
TENNIS	t E n @ s
TENOR	t E n @
TENSE	t E n s
TENT	t E n t
TENTACLE	t E n t @ k @ l
TENTATIVE	t E n t @ t I v
TENTH	t E n T
TENUOUS	t E n j u: @ s
TEPID	t E p @ d
TERM	t @: m
TERMINAL	t @: m @ n @ l
TERMINATE	t @: m @ n EI t
TERMINOLOGY	t @: m @ n O l @ dZ i:
TERMINUS	t @: m @ n @ s
TERMITE	t @: m a: I t
TERRACE	t E r @ s
TERRAIN	t @ r EI n
TERRESTRIAL	t @ r E s t r i: @ l
TERRIBLE	t E r @ b @ l
TERRIBLY	t E r @ b l i:
TERRIFIC	t @ r I f I k
TERRIFY	t E r @ f a: I
TERRITORY	t E r @ t r i:
TERROR	t E r @
TERRORISE	t E r @ r a: I z
TERRORISM	t E r @ r I z @ m
TERSE	t @: s
TERTIARY	t @: S @ r i:
TEST	t E s t
TESTAMENT	t E s t @ m @ n t
TESTICLE	t E s t I k @ l
TESTIFY	t E s t @ f a: I
TESTIMONIAL	t E s t @ m @U n i: @ l
TESTIMONY	t E s t @ m @ n i:
TETHER	t E D @
TEXT	t E k s t
TEXTA	t E k s t @
TEXTBOOK	t E k s t b U k
TEXTILE	t E k s t a: I l
TEXTURE	t E k s tS @
THAI	t a: I
THAN	D A n
THANK	T A N k
THAT	D A t
THATCH	T A tS
THAW	T o:
THE	D @
THEATRE	T I@ t @
THEATRICAL	T i: A t r I k @ l
THEFT	T E f t
THEIR	D E@
THEIRS	D E@ z
THEM	D E m
THEME	T i: m
THEMSELVES	D @ m s E l v z
THEN	D E n
THEOLOGY	T i: O l @ dZ i:
THEOREM	T I@ r @ m
THEORY	T I@ r i:
THERAPEUTIC	T E r @ p j u: t I k
THERAPY	T E r @ p i:
THERE	D E@
THEREABOUTS	D E@ r @ b a: U t s
THEREAFTER	D E@ r a: f t @
THEREBY	D E@ b a: I
THEREFORE	D E@ f o:
THERELL	D E@ l
THEREUPON	D E@ r @ p O n
THERMOMETER	T @ m O m @ t @
THERMOS	T @: m O s
THERMOSTAT	T @: m @ s t A t
THESAURUS	T @ s o: r @ s
THESE	D i: z
THESIS	T i: s @ s
THEY	D EI
THICK	T I k
THICKET	T I k @ t
THIEF	T i: f
THIGH	T a: I
THIMBLE	T I m b @ l
THIN	T I n
THING	T I N
THINK	T I N k
THIRD	T @: d
THIRST	T @: s t
THIRTEEN	T @: t i: n
THIRTEENTH	T @: t i: n T
THIRTY	T @: t i:
THIS	D I s
THISTLE	T I s @ l
THONG	T O N
THORN	T o: n
THOROUGH	T a r @
THOROUGHFARE	T a r @ f E@
THOROUGHLY	T a r @ l i:
THOSE	D @U z
THOUGH	D @U
THOUGHT	T o: t
THOUGHTFUL	T o: t f U l
THOUGHTLESS	T o: t l @ s
THOUSAND	T a: U z @ n d
THOUSANDTH	T a: U z @ n T
THRASH	T r A S
THREAD	T r E d
THREADBARE	T r E d b E@
THREAT	T r E t
THREATEN	T r E t @ n
THREE	T r i:
THREE-DIMENSIONAL	T r i: d @ m E n S @ n @ l
THRESH	T r E S
THRESHOLD	T r E S h @U l d
THREW	T r u:
THRIFT	T r I f t
THRIFTY	T r I f t i:
THRILL	T r I l
THRILLER	T r I l @
THRIVE	T r a: I v
THROAT	T r @U t
THROB	T r O b
THRONE	T r @U n
THRONG	T r O N
THROTTLE	T r O t @ l
THROUGH	T r u:
THROUGHOUT	T r u: a: U t
THROW	T r @U
THRUST	T r a s t
THUD	T a d
THUG	T a g
THUMB	T a m
THUMP	T a m p
THUNDER	T a n d @
THURSDAY	T @: z d EI
THUS	D a s
THWART	T w o: t
THYME	t a: I m
THYROID	T a: I r o: I d
TICK	t I k
TICKET	t I k @ t
TICKLE	t I k @ l
TICKLISH	t I k l I S
TIDDLY	t I d l i:
TIDE	t a: I d
TIDY	t a: I d i:
TIE	t a: I
TIER	t I@
TIGERSNAKE	t a: I g @ s n EI k
TIGHT	t a: I t
TIGHTS	t a: I t s
TILE	t a: I l
TILL	t I l
TILT	t I l t
TIMBER	t I m b @
TIME	t a: I m
TIMELY	t a: I m l i:
TIMETABLE	t a: I m t EI b @ l
TIMID	t I m @ d
TIN	t I n
TINEA	t I n i: @
TINGE	t I n Z
TINGLE	t I N g @ l
TINKER	t I N k @
TINKLE	t I N k @ l
TINNIE	t I n i:
TINNY	t I n i:
TINSEL	t I n s @ l
TINT	t I n t
TINY	t a: I n i:
TIP	t I p
TIPSY	t I p s i:
TIRADE	t a: I r EI d
TIRE	t a: I@
TIRED	t a: I@ d
TIRING	t a: I@ r I N
TISSUE	t I S u:
TIT	t I t
TITBIT	t I t b I t
TITLE	t a: I t @ l
TITTER	t I t @
TO	t u:
TOAD	t @U d
TOADSTOOL	t @U d s t u: l
TOAST	t @U s t
TOASTER	t @U s t @
TOBACCO	t @ b A k @U
TOBOGGAN	t @ b O g @ n
TODAY	t @ d EI
TODDLE	t O d @ l
TODDLER	t O d l @
TOE	t @U
TOGETHER	t @ g E D @
TOIL	t o: I l
TOILET	t o: I l @ t
TOILETRIES	t o: I l @ t r i: z
TOKEN	t @U k @ n
TOLD	t @U l d
TOLERABLE	t O l @ r @ b @ l
TOLERABLE	t O l r @ b @ l
TOLERANT	t O l @ r @ n t
TOLERATE	t O l @ r EI t
TOLL	t O l
TOLL	t @U l
TOMATO	t @ m a: t @U
TOMB	t u: m
TOMBSTONE	t u: m s t @U n
TOMCAT	t O m k A t
TOMORROW	t @ m O r @U
TON	t a n
TONE	t @U n
TONGUE	t a N
TONIC	t O n I k
TONIGHT	t @ n a: I t
TONNE	t O n
TONSIL	t O n s @ l
TONSILITIS	t O n s @ l a: I t @ s
TOO	t u:
TOOK	t U k
TOOL	t u: l
TOOT	t u: t
TOOTH	t u: T
TOOTHACHE	t u: T EI k
TOOTHBRUSH	t u: T b r a S
TOOTHPASTE	t u: T p EI s t
TOOTHPICK	t u: T p I k
TOP	t O p
TOPIC	t O p I k
TOPICAL	t O p I k @ l
TOPLESS	t O p l @ s
TOPPING	t O p I N
TOPPLE	t O p @ l
TORCH	t o: tS
TORE	t o:
TORMENT	t o: m E n t
TORN	t o: n
TORTUOUS	t o: tS u: @ s
TORTURE	t o: tS @
TOSS	t O s
TOTAL	t @U t @ l
TOTALITARIAN	t @U t A l @ t E@ r i: @ n
TOTEM	t @U t @ m
TOTTER	t O t @
TOUCH	t a tS
TOUCHY	t a tS i:
TOUGH	t a f
TOUR	t U@
TOURISM	t U@ r I s @ m
TOURISM	t u: @ r I s @ m
TOURIST	t U@ r @ s t
TOURIST	t u: @ r @ s t
TOURNAMENT	t o: n @ m @ n t
TOW	t @U
TOWARDS	t @ w o: d z
TOWEL	t a: U@ l
TOWER	t a: U@
TOWN	t a: U n
TOWNHALL	t a: U n h o: l
TOXIC	t O k s I k
TOXIN	t O k s @ n
TOY	t o: I
TRACE	t r EI s
TRACK	t r A k
TRACKSUIT	t r A k s u: t
TRACTOR	t r A k t @
TRADE	t r EI d
TRADEUNION	t r EI d j u: n j @ n
TRADE-IN	t r EI d I n
TRADEMARK	t r EI d m a: k
TRADITION	t r @ d I S @ n
TRAFFIC	t r A f I k
TRAFFICJAM	t r A f I k dZ A m
TRAGEDY	t r A dZ @ d i:
TRAGIC	t r A dZ I k
TRAIL	t r EI l
TRAILER	t r EI l @
TRAIN	t r EI n
TRAINEE	t r EI n i:
TRAINING	t r EI n I N
TRAIT	t r EI t
TRAITOR	t r EI t @
TRAM	t r A m
TRAMPLE	t r A m p @ l
TRANQUIL	t r A N k w @ l
TRANQUILLISER	t r A N k w @ l a: I z @
TRANSFER	t r A n s f @:
TRANSFORM	t r A n s f o: m
TRANSFUSION	t r A n s f j u: Z @ n
TRANSITIVE	t r A n z @ t I v
TRANSLATE	t r A n z l EI t
TRANSMIT	t r A n z m I t
TRANSPARENT	t r A n s p E@ r @ n t
TRANSPLANT	t r A n s p l A n t
TRANSPORT	t r A n s p o: t
TRAP	t r A p
TRAUMA	t r o: m @
TRAVEL	t r A v @ l
TRAVELAGENT	t r A v @ l EI dZ @ n t
TRAY	t r EI
TREACHEROUS	t r E tS @ r @ s
TREACHERY	t r E tS @ r i:
TREAD	t r E d
TREASURE	t r E Z @
TREASURER	t r E Z @ r @
TREAT	t r i: t
TREE	t r i:
TREMBLE	t r E m b @ l
TREMENDOUS	t r @ m E n d @ s
TREND	t r E n d
TRENDY	t r E n d i:
TRESPASS	t r E s p @ s
TRIAL	t r a: I@ l
TRIANGLE	t r a: I A N g @ l
TRIBUNAL	t r a: I b j u: n @ l
TRIBUNAL	t r @ b j u: n @ l
TRICK	t r I k
TRICKLE	t r I k @ l
TRIED	t r a: I d
TRIM	t r I m
TRIP	t r I p
TRIPLE	t r I p @ l
TRIUMPH	t r a: I a m f
TRIVIAL	t r I v i: @ l
TROD	t r O d
TRODDEN	t r O d @ n
TROLLEY	t r O l i:
TROOP	t r u: p
TROPICAL	t r O p I k @ l
TROPICS	t r O p I k s
TROUBLE	t r a b @ l
TROUSERS	t r a: U z @ z
TRUCK	t r a k
TRUDGE	t r a dZ
1	t r u:
TRUMPET	t r a m p @ t
TRUNK	t r a N k
TRUST	t r a s t
TRUSTWORTHY	t r a s t w @: D i:
TRUTH	t r u: T
TRUTHFUL	t r u: T f U l
TRY	t r a: I
TUBE	tS u: b
TUBE	t j u: b
TUCK	t a k
TUESDAY	t j u: z d EI
TUFT	t a f t
TUG	t a g
TUITION	tS u: I S @ n
TUITION	t j u: I S @ n
TUMBLE	t a m b @ l
TUMOUR	t j u: m @
TUNA	t j u: n @
TUNE	t j u: n
TUNNEL	t a n @ l
TURKISH	t @: k I S
TURN	t @: n
TURQUOISE	t @: k w o: I z
TUTOR	t j u: t @
TV	t i: v i:
TWEEZERS	t w i: z @ z
TWELFTH	t w E l f T
TWELVE	t w E l v
TWENTIETH	t w E n t i: @ T
TWENTY	t w E n t i:
TWICE	t w a: I s
TWIG	t w I g
TWILIGHT	t w a: I l a: I t
TWIN	t w I n
TWINGE	t w I n dZ
TWINKLE	t w I N k @ l
TWIST	t w I s t
TWO	t u:
TYING	t a: I I N
TYPE	t a: I p
TYPEWRITER	t a: I p r a: I t @
TYPHOID	t a: I f o: I d
TYPHOON	t a: I f u: n
TYPICAL	t I p I k @ l
TYPICALLY	t I p I k l i:
TYRE	t a: I@
U	j u:
UGLY	a g l i:
ULCER	a l s @
ULTIMATE	a l t @ m @ t
UM	a m
UMBRELLA	a m b r E l @
UMPIRE	a m p a: I@
UMPTEEN	a m p t i: n
UNANIMOUS	j u: n A n @ m @ s
UNCANNY	a n k A n i:
UNCLE	a N k @ l
UNCONSCIOUS	a n k O n S @ s
UNDER	a n d @
UNDERARM	a n d @ r a: m
UNDERDONE	a n d @ d a n
UNDERGO	a n d @ g @U
UNDERGROWTH	a n d @ g r @U T
UNDERHAND	a n d @ h A n d
UNDERLINE	a n d @ l a: I n
UNDERNEATH	a n d @ n i: T
UNDERPANTS	a n d @ p A n t s
UNDERSTAND	a n d @ s t A n d
UNDERSTATE	a n d @ s t EI t
UNDERTAKE	a n d @ t EI k
UNDERTAKER	a n d @ t EI k @
UNDERWEAR	a n d @ w E@
UNDO	a n d u:
UNEASY	a n i: z i:
UNEMPLOYED	a n E m p l o: I d
UNEVENTFUL	a n @ v E n t f U l
UNFORGETTABLE	a n f @ g E t @ b @ l
UNIFORM	j u: n @ f o: m
UNIFY	j u: n @ f a: I
UNILATERAL	j u: n i: l A t @ r @ l
UNINTERESTED	a n I n t r @ s t @ d
UNION	j u: n j @ n
UNIQUE	j u: n i: k
UNISEX	j u: n i: s E k s
UNISON	j u: n @ s @ n
UNIT	j u: n @ t
UNITE	j u: n a: I t
UNIVERSAL	j u: n @ v @: s @ l
UNIVERSE	j u: n @ v @: s
UNIVERSITY	j u: n @ v @: s @ t i:
UNKNOWN	a n n @U n
UNLAWFUL	a n l o: f U l
UNLESS	a n l E s
UNRAVEL	a n r A v @ l
UNREAL	a n r i: l
UNREST	a n r E s t
UNSCATHED	a n s k EI D d
UNSCREW	a n s k r u:
UNSCRUPULOUS	a n s k r u: p j @ l @ s
UNSETTLE	a n s E t @ l
UNTANGLE	a n t A N g @ l
UNTHINKABLE	a n T I N k @ b @ l
UNTIE	a n t a: I
UNTIL	a n t I l
UNUSUAL	a n j u: Z u: @ l
UNWIELDY	a n w I@ l d i:
UP	a p
UP-MARKET	a p m a: k @ t
UP-TO-DATE	a p t @ d EI t
UPBRINGING	a p b r I N I N
UPDATE	a p d EI t
UPGRADE	a p g r EI d
UPHEAVAL	a p h i: v @ l
UPHILL	a p h I l
UPHOLD	a p h @U l d
UPHOLSTERY	a p h @U l s t r i:
UPKEEP	a p k i: p
UPON	@ p O n
UPPER	a p @
UPPERMOST	a p @ m @U s t
UPRIGHT	a p r a: I t
UPRISING	a p r a: I z I N
UPROAR	a p r o:
UPROARIOUS	a p r o: r i: @ s
UPSET	a p s E t
UPSIDEDOWN	a p s a: I d d a: U n
UPSTAIRS	a p s t E@ z
UPSTREAM	a p s t r i: m
UPTIGHT	a p t a: I t
UPTURN	a p t @: n
UPWARD	a p w @ d
UPWARDS	a p w @ d z
UPWIND	a p w I n d
URANIUM	j u: r EI n i: @ m
URBAN	@: b @ n
URBANE	@: b EI n
URGE	@: dZ
URGENT	@: dZ @ n t
URINAL	j u: r @ n @ l
URINE	j u: r @ n
URN	@: n
US	a s
USE	j u: z
USED	j u: z d
USUAL	j u: Z u: @ l
UTE	j u: t
UTENSIL	j u: t E n s @ l
UTERUS	j u: t @ r @ s
UTILITIES	j u: t I l @ t i: z
UTILITYTRUCK	j u: t I l @ t i: t r a k
UTTER	a t @
V	v i:
VACANCY	v EI k @ n s i:
VACANT	v EI k @ n t
VACATION	v EI k EI S @ n
VACATION	v @ k EI S @ n
VACCINE	v A k s i: n
VACUUM	v A k j u: m
VAGINA	v @ dZ a: I n @
VAGUE	v EI g
VAIN	v EI n
VALID	v A l @ d
VALLEY	v A l i:
VALUABLE	v A l j @ b @ l
VALUE	v A l j u:
VALVE	v A l v
VAN	v A n
VANDAL	v A n d @ l
VANILLA	v @ n I l @
VANISH	v A n I S
VANITY	v A n @ t i:
VAPOUR	v EI p @
VARIETY	v @ r a: I@ t i:
VARIOUS	v E@ r i: @ s
VARNISH	v a: n I S
VARY	v E@ r i:
VASE	v a: z
VAST	v a: s t
VAT	v A t
VCR	v i: s i: a:
VDU	v i: d i: j u:
VEAL	v i: l
VEGAN	v i: g @ n
VEGETABLE	v E dZ t @ b @ l
VEGETARIAN	v E dZ @ t E@ r i: @ n
VEGETATION	v E dZ @ t EI S @ n
VEGIE	v E dZ i:
VEHEMENT	v i: @ m @ n t
VEHICLE	v I@ k @ l
VEIL	v EI l
VEIN	v EI n
VELVET	v E l v @ t
VENEER	v @ n I@
VENEREALDISEASE	v @ n I@ r i: @ l d @ z i: z
VENGEANCE	v E n dZ @ n s
VENOM	v E n @ m
VENTILATE	v E n t @ l EI t
VENTURE	v E n tS @
VENUE	v E n j u:
VERANDA	v @ r A n d @
VERB	v @: b
VERBAL	v @: b @ l
VERDICT	v @: d I k t
VERIFY	v E r @ f a: I
VERSATILE	v @: s @ t a: I l
VERSE	v @: s
VERSION	v @: Z @ n
VERSUS	v @: s @ z
VERTEBRA	v @: t @ b r @
VERTICAL	v @: t I k @ l
VERY	v E r i:
VESSEL	v E s @ l
VET	v E t
VETO	v i: t @U
VEX	v E k s
VIA	v a: I@
VIBRATE	v a: I b r EI t
VIC	v I k t o: r i: @
VICE	v a: I s
VICEVERSA	v a: I s @ v @: s @
VICINITY	v @ s I n @ t i:
VICIOUS	v I S @ s
VICTIM	v I k t @ m
VICTIMISE	v I k t @ m a: I z
VICTORY	v I k t @ r i:
VIDEO	v I d i: @U
VIDEOTAPE	v I d i: @U t EI p
VIETNAMESE	v i: E t n @ m i: z
VIEW	v j u:
VIEWER	v j u: @
VIGOROUS	v I g @ r @ s
VILE	v a: I l
VILLAGE	v I l I dZ
VILLAIN	v I l @ n
VINDICTIVE	v I n d I k t I v
VINE	v a: I n
VINEGAR	v I n I g @
VINEYARD	v I n j @ d
VINTAGE	v I n t I dZ
VINYL	v a: I n @ l
VIOLENT	v a: I@ l @ n t
VIOLIN	v a: I@ l I n
VIP	v i: a: I p i:
VIRGIN	v @: dZ @ n
VIRILE	v I r a: I l
VIRTUE	v @: tS u:
VIRULENT	v I r @ l @ n t
VIRUS	v a: I r @ s
VISA	v i: z @
VISIBLE	v I z @ b @ l
VISION	v I Z @ n
VISIT	v I z @ t
VISUAL	v I Z u: @ l
VISUALDISPLAYUNIT	v I Z u: @ l d @ s p l EI j u: n @ t
VISUALISE	v I Z j @ l a: I z
VITAL	v a: I t @ l
VITALITY	v a: I t A l @ t i:
VITAMIN	v a: I t @ m @ n
VIVACIOUS	v @ v EI S @ s
VIVID	v I v @ d
VOCABULARY	v @ k A b j @ l @ r i:
VOCAL	v @U k @ l
VOCALIST	v @U k @ l @ s t
VOGUE	v @U g
VOICE	v o: I s
VOID	v o: I d
VOLCANO	v O l k EI n @U
VOLLEY	v O l i:
VOLLEYBALL	v O l i: b o: l
VOLUME	v O l j u: m
VOLUNTARY	v O l @ n t r i:
VOLUNTEER	v O l @ n t I@
VOMIT	v O m @ t
VOTE	v @U t
VOUCHER	v a: U tS @
VOW	v a: U
VOWEL	v a: U@ l
VOYAGE	v o: I I dZ
VS	v @: s @ z
VULGAR	v a l g @
VULNERABLE	v a l n r @ b @ l
W	d a b @ l j u:
W	w E s t
WA	w E s t @ n @ s t r EI l j @
WAD	w O d
WADDLE	w O d @ l
WADE	w EI d
WAFER	w EI f @
WAG	w A g
WAGE	w EI dZ
WAGER	w EI dZ @
WAIL	w EI l
WAIST	w EI s t
WAIT	w EI t
WAITER	w EI t @
WAKE	w EI k
WALK	w o: k
WALKOVER	w o: k @U v @
WALL	w o: l
WALLET	w O l @ t
WALLPAPER	w o: l p EI p @
WALTZ	w o: l s
WALTZ	w O l t s
WANDER	w O n d @
WANE	w EI n
WANGLE	w A N g @ l
WANK	w A N k
WANT	w O n t
WAR	w o:
WARD	w o: d
WARDEN	w o: d @ n
WARDER	w o: d @
WARDROBE	w o: d r @U b
WAREHOUSE	w E@ h a: U s
WARFARE	w o: f E@
WARM	w o: m
WARN	w o: n
WARNING	w o: n I N
WARP	w o: p
WARPED	w o: p t
WARRANT	w O r @ n t
WARRANTY	w O r @ n t i:
WART	w o: t
WARY	w E@ r i:
WAS	w O z
WASH	w O S
WASHED-OUT	w O S t a: U t
WASHER	w O S @
WASTE	w EI s t
WASTEPAPERBASKET	w EI s t p EI p @ b a: s k @ t
WATCH	w O tS
WATER	w o: t @
WATERCOLOUR	w o: t @ k a l @
WATERFRONT	w o: t @ f r a n t
WATERLOGGED	w o: t @ l O g d
WATERPROOF	w o: t @ p r u: f
WATERSKI	w o: t @ s k i:
WATERTIGHT	w o: t @ t a: I t
WATT	w O t
WATTLE	w O t @ l
WAVE	w EI v
WAX	w A k s
WAY	w EI
WAY-OUT	w EI a: U t
WE	w i:
WEAK	w i: k
WEALTH	w E l T
WEALTHY	w E l T i:
WEAPON	w E p @ n
WEAR	w E@
WEARY	w I@ r i:
WEATHER	w E D @
WEAVE	w i: v
WEB	w E b
WEBBED	w E b d
WEDDING	w E d I N
WEDGE	w E dZ
WEDNESDAY	w E n z d EI
WEED	w i: d
WEEK	w i: k
WEEKDAY	w i: k d EI
WEEKEND	w i: k E n d
WEEKLY	w i: k l i:
WEEP	w i: p
WEIGH	w EI
WEIGHT	w EI t
WEIRD	w I@ d
WELCOME	w E l k @ m
WELD	w E l d
WELFARE	w E l f E@
WELL	w E l
WELL-OFF	w E l O f
WELLBEING	w E l b i: I N
WENT	w E n t
WEPT	w E p t
WERE	w @:
WERENT	w @: n t
WEST	w E s t
WESTERN	w E s t @ n
WET	w E t
WHACK	w A k
WHARF	w o: f
WHAT	w O t
WHATEVER	w O t E v @
WHATSOEVER	w O t s @U E v @
WHEAT	w i: t
WHEEL	w i: l
WHEELBARROW	w i: l b A r @U
WHEELCHAIR	w i: l tS E@
WHEN	w E n
WHENEVER	w E n E v @
WHERE	w E@
WHEREABOUTS	w E@ r @ b a: U t s
WHEREAS	w E@ r A z
WHEREVER	w E@ r E v @
WHETHER	w E D @
WHICH	w I tS
WHIFF	w I f
WHILE	w a: I l
WHIM	w I m
WHIMPER	w I m p @
WHINE	w a: I n
WHINGE	w I n dZ
WHIP	w I p
WHIRL	w @: l
WHIRLWIND	w @: l w I n d
WHIRR	w @:
WHISK	w I s k
WHISKER	w I s k @
WHISKY	w I s k i:
WHISPER	w I s p @
WHISTLE	w I s @ l
WHITE	w a: I t
WHITEANT	w a: I t A n t
WHITE-ANT	w a: I t A n t
WHITE-OUT	w a: I t a: U t
WHITEWASH	w a: I t w O S
WHIZ	w I z
WHO	h u:
WHOEVER	h u: E v @
WHOLE	h @U l
WHOLEMEAL	h @U l m i: l
WHOLESALE	h @U l s EI l
WHOLESOME	h @U l s @ m
WHOM	h u: m
WHOPPING	w O p I N
WHORE	h o:
WHOSE	h u: z
WHY	w a: I
WICK	w I k
WICKED	w I k @ d
WICKET	w I k @ t
WIDE	w a: I d
WIDESPREAD	w a: I d s p r E d
WIDOW	w I d @U
WIDOWER	w I d @U @
WIFE	w a: I f
WIG	w I g
WIGGLE	w I g @ l
WILD	w a: I l d
WILDFLOWER	w a: I l d f l a: U@
WILDERNESS	w I l d @ n @ s
WILDLIFE	w a: I l d l a: I f
WILFUL	w I l f @ l
WILL	w I l
WILLING	w I l I N
WILLPOWER	w I l p a: U@
WILT	w I l t
WILY	w a: I l i:
WIMP	w I m p
WIN	w I n
WINCE	w I n s
WIND	w I n d
WIND	w a: I n d
WINDOW	w I n d @U
WINDOWSHOPPING	w I n d @U S O p I N
WINDOWS	w I n d @U z
WINDOWSILL	w I n d @U s I l
WINDPIPE	w I n d p a: I p
WINDSCREEN	w I n d s k r i: n
WINDSURF	w I n d s @: f
WINDY	w I n d i:
WINE	w a: I n
WING	w I N
WINK	w I N k
WINNING	w I n I N
WINTER	w I n t @
WIPE	w a: I p
WIRE	w a: I@
WIRY	w a: I@ r i:
WISDOMTOOTH	w I z d @ m t u: T
WISE	w a: I z
WISH	w I S
WISHY-WASHY	w I S i: w O S i:
WIT	w I t
WITCH	w I tS
WITH	w I T
WITHDRAW	w I D d r o:
WITHDRAW	w I T d r o:
WITHHOLD	w I D h @U l d
WITHHOLD	w I T h @U l d
WITHIN	w I D I n
WITHOUT	w I D a: U t
WITNESS	w I t n @ s
WIZARD	w I z @ d
WOBBLE	w O b @ l
WOE	w @U
WOEFUL	w @U f U l
WOG	w O g
WOK	w O k
WOKE	w @U k
WOLF	w U l f
WOMAN	w U m @ n
WOMB	w u: m
WOMBAT	w O m b A t
WON	w a n
WONDER	w a n d @
WONDERFUL	w a n d @ f U l
WOOD	w U d
WOODEN	w U d @ n
WOODWORK	w U d w @: k
WOOL	w U l
WORD	w @: d
WORDPROCESSOR	w @: d p r @U s E s @
WORE	w o:
WORK	w @: k
WORKBENCH	w @: k b E n tS
WORKFORCE	w @: k f o: s
WORKLOAD	w @: k l @U d
WORKOUT	w @: k a: U t
WORKPLACE	w @: k p l EI s
WORKSHOP	w @: k S O p
WORLD	w @: l d
WORLDWIDE	w @: l d w a: I d
WORM	w @: m
WORN	w o: n
WORN-OUT	w o: n a: U t
WORRY	w a r i:
WORSE	w @: s
WORSHIP	w @: S I p
WORST	w @: s t
WORTH	w @: T
WORTHWHILE	w @: T w a: I l
WORTHY	w @: D i:
WOULD	w U d
WOUND	w u: n d
WOUND	w a: U n d
WOVEN	w @U v @ n
WOW	w a: U
WOWSER	w a: U z @
WRAP	r A p
WREATH	r i: T
WRECK	r E k
WRESTLE	r E s @ l
WRETCH	r E tS
WRIGGLE	r I g @ l
WRING	r I N
WRINKLE	r I N k @ l
WRIST	r I s t
WRITE	r a: I t
WRITE-OFF	r a: I t O f
WRONG	r O N
WROTE	r @U t
WRUNG	r a N
WUSS	w U s
X	E k s
X-RAY	E k s r EI
XMAS	k r I s m @ s
Y	w a: I
YACHT	j O t
YAK	j A k
YAKKA	j A k @
YANK	j A N k
YAP	j A p
YARD	j a: d
YARN	j a: n
YAWN	j o: n
YD	j a: d
YEAH	j E@
YEAR	j I@
YEAST	j i: s t
YELL	j E l
YELLOW	j E l @U
YELP	j E l p
YEN	j E n
YES	j E s
YESTERDAY	j E s t @ d EI
YET	j E t
YIELD	j i: l d
YOGA	j @U g @
YOGHURT	j @U g @ t
YOLK	j @U k
YONKS	j O N k s
YOU	j u:
YOUNG	j a N
YOUNGSTER	j a N s t @
YOUR	j o:
YOURS	j o: z
YOURSELF	j o: s E l f
YOUTH	j u: T
YR	j I@
YUK	j a k
YUPPIE	j a p i:
Z	z E d
ZEAL	z i: l
ZERO	z I@ r @U
ZEST	z E s t
ZIGZAG	z I g z A g
ZINC	z I N k
ZIP	z I p
ZODIAC	z @U d i: A k
ZOMBIE	z O m b i:
ZONE	z @U n
ZOO	z u:
ZOOLOGY	z @U O l @ dZ i:
ZOOM	z u: m
ZUCCHINI	z @ k i: n i:
