A	EI	
AM	EI'Em	
abandon	@'bAnd@n	
abbreviation	@bri:vi:'EIS@n	
abc	EIbi:'si:	
abdomen	'Abd@m@n	
abide	@'ba:Id	
ability	@'bIl@ti:	
ablaze	@'blEIz	
able	'EIb@l	
abnormal	Ab'no:m@l	
abnormality	Abno:'mAl@ti:	
abolish	@'bOlIS	
abominable	@'bOmn@b@l	@'bOm@n@b@l
aborigine	Ab@'rIdZ@ni:	
abort	@'bo:t	
abortion	@'bo:S@n	
about	@'ba:Ut	
above	@'bav	
abrasion	@'brEIZ@n	
abroad	@'bro:d	
abrupt	@'brapt	
abscess	'AbsEs	
absent	'Abs@nt	
absent-minded	Abs@nt-'ma:Ind@d	
absolute	'Abs@lu:t	'Abs@lu:t
absorb	@b'so:b	@b'zo: b
abstract	'AbstrAkt	
absurd	@b's@:d	@b'z@:d
abuse	@'bju:z	
academy	@'kAd@mi:	
accelerate	@k'sEl@rEIt	
accent	'AksEnt	
accept	@k'sEpt	
access	'AksEs	
accident	'Aks@d@nt	
accommodate	@'kOm@dEIt	
accompany	@'kamp@ni:	
accomplice	@'kampl@s	
accord	@'ko:d	
accordingly	@'ko:dINli:	
account	@'ka:Unt	
accountable	@'ka:Unt@b@l	
accountant	@'ka:Unt@nt	
accumulate	@'kju:mj@lEIt	
accurate	'Akj@r@t	
accuse	@'kju:z	
accustomed	@'kast@md	
ace	EIs	
ache	EIk	
achieve	@'tSi:v	
acid	'As@d	
acknowledge	@k'nOlIdZ	
acne	'Akni:	
acoustics	@'ku:stIks	
acquaint	@'kwEInt	
acquaintance	@'kwEInt@ns	
acquire	@'kwa:I@	
acquit	@'kwIt	
acre	'EIk@	
acrobat	'Akr@bAt	
acronym	'Akr@nIm	
across	@'krOs	
across-the-board	@'krOs-D@-bo:d	
acrylic	@'krIlIk	
ACT	EIsi:'ti:	
action	'AkS@n	
activate	'Akt@vEIt	
active	'AktIv	
activity	Ak'tIv@ti:	
actor	'Akt@	
actu	EIsi:ti:'ju:	
actual	'AktSu:@l	
actually	'AktSu:@li:	'AktS@li:
acupuncture	'Akj@paNktS@	
acute	@'kju:t	
acutely	@'kju:tli:	
AD	EI'di:	
adamsapple	'Ad@mzAp@l	
adapt	@'dApt	
add	Ad	
addict	'AdIkt	
addicted	@'dIkt@d	
addition	@'dIS@n	
additive	'Ad@tIv	
address	@'drEs	
adequate	'Ad@kw@t	
adhesive	@d'hi:sIv	@d'hi:zIv
adjacent	@'dZEIs@nt	
adjective	'AdZ@ktIv	'AdZEktIv
adjourn	@'dZ@:n	
adjudicate	@'dZu:d@kEIt	
adjust	@'dZast	
adjustment	@'dZastm@nt	
admin	'AdmIn	
administration	@dmIn@'strEIS@n	
admire	@d'ma:I@	
admission	@d'mIS@n	
admit	@d'mIt	
admittance	@d'mIt@ns	
adolescence	Ad@'lEs@ns	
adopt	@'dOpt	
adore	@'do:	
adult	'Adalt	
adultery	@'dalt@ri:	
advance	@d'vAns	
advanced	@d'vAnst	
advancement	@d'vAnsm@nt	
advantage	@d'vAntIdZ	
adventure	@d'vEntS@	
adverse	'Adv@:s	
adversity	@d'v@:s@ti:	
advertise	'Adv@ta:Iz	
advertisement	@d'v@:t@sm@nt	
advice	@d'va:Is	
advisable	@d'va:Iz@b@l	
advise	@d'va:Iz	
advocate	'Adv@kEIt	
aerial	'E@ri:@l	
aerobics	@'r@UbIks	
aerodrome	'E@r@dr@Um	
aeroplane	'E@r@plEIn	
aerosol	'E@r@sOl	
affair	@'fE@	
affect	@'fEkt	
affectation	AfEk'tEIS@n	
affected	@'fEkt@d	
affection	@'fEkS@n	
affirm	@'f@:m	
affirmative	@'f@:m@tIv	
affluent	'Aflu:@nt	
afford	@'fo:d	
afloat	@'fl@Ut	
afraid	@'frEId	
after	'a:ft@	
after-effect	'a:ft@r-@fEkt	
after-hours	'a:ft@r-a:U@z	
afterlife	'a:ft@la:If	
afternoon	a:ft@'nu:n	
aftershave	'a:ft@SEIv	
afterwards	'a:ft@w@dz	
again	@'ɡEn	
against	@'ɡEnst	
age	EIdZ	
aged	EIdZd	
ageing	'EIdZIN	
ageism	'EIdZIz@m	
agency	'EIdZ@nsi:	
agenda	@'dZEnd@	
agent	'EIdZ@nt	
aggravate	Aɡr@vEIt	
aggression	@'ɡrES@n	
aggressive	@'ɡrEsIv	
aggro	Aɡr@U	
agile	'AdZa:Il	
agitate	'AdZ@tEIt	
agnostic	Aɡ'nOstIk	
ago	@'ɡ@U	
agony	Aɡ@ni:	
agree	@'ɡri:	
agreement	@'ɡri:m@nt	
agriculture	Aɡr@kaltS@	
ahead	@'hEd	
aid	EId	
aids	EIdz	
aim	EIm	
aimless	'EIml@s	
air	E@	
airforce	'E@fo:s	
airraid	'E@rEId	
airtrafficcontrol	E@trAfIkk@n'tr@Ul	
aircon	'E@kOn	
airconditioning	E@k@n'dIS@nIN	
aircraft	'E@kra:ft	
aircraftcarrier	'E@kra:ftkAri:@	
airlift	'E@lIft	
airline	'E@la:In	
airmail	'E@mEIl	
airport	'E@po:t	
aisle	a:Il	
ajar	@'dZa:	
alarm	@'la:m	
alarmclock	@'la:mklOk	
alarmist	@'la:m@st	
album	'Alb@m	
alcohol	'Alk@hOl	
alcoholic	Alk@'hOlIk	
ale	EIl	
alert	@'l@:t	
algebra	'AldZ@br@	
alias	'EIli:@s	
alibi	'Al@ba:I	
alien	'EIli:@n	
alienate	'EIli:@nEIt	
alight	@'la:It	
align	@'la:In	
alike	@'la:Ik	
alive	@'la:Iv	
alkali	'Alk@la:I	
all	o:l	
allright	o:l'ra:It	
allege	@'lEdZ	
allegiance	@'li:dZ@ns	
allegory	Al@ɡ@ri:	
allergy	'Al@dZi:	
alleviate	@'li:vi:EIt	
alley	Ali:	
alliance	@'la:I@ns	
allocate	'Al@kEIt	
allot	@'lOt	
allow	@'la:U	
allowance	@'la:U@ns	
allure	@'lu:@	
ally	'Ala:I	
almighty	o:l'ma:Iti:	
almost	'o:lm@Ust	
alone	@'l@Un	
along	@'lON	
aloud	@'la:Ud	
alp	EIEl'pi:	Alp
alphabet	'Alf@bEt	
alpine	'Alpa:In	
already	o:l'rEdi:	
alright	o:l'ra:It	
also	'o:ls@U	
altar	'Olt@	
alter	'Olt@	
altercation	Olt@'kEIS@n	
alternate	Ol't@:n@t	'Olt@nEIt
alternative	Ol't@:n@tIv	
although	o:l'D@U	
altitude	'Alt@tju:d	
altogether	o:lt@'ɡED@	
aluminium	Alj@'mInj@m	Alj@'mIni:@m
always	'o:lwEIz	
am	EI'Em	Am
ama	EIEm'EI	
amalgamate	@'mAlɡ@mEIt	
amass	@'mAs	
amateur	'Am@t@	
amaze	@'mEIz	
ambassador	Am'bAs@d@	
amber	'Amb@	
ambiguous	Am'bIɡju:@s	
ambition	Am'bIS@n	
amble	'Amb@l	
ambulance	'Ambj@l@ns	
ambush	'AmbUS	
amenable	@'mEn@b@l	
amend	@'mEnd	
amenity	@'mEn@ti:	
amiable	'EImi:@b@l	
amicable	'AmIk@b@l	
ammonia	@'m@Uni:@	
ammunition	Amj@'nIS@n	
amnesia	Am'ni:Z@	
among	@'maN	
amorous	'Am@r@s	
amount	@'ma:Unt	
ample	'Amp@l	
amplify	'Ampl@fa:I	
amputate	'Ampj@tEIt	
amputee	Ampj@'ti:	
amuse	@'mju:z	
amusement	@'mju:zm@nt	
an	An	
anaemia	@'ni:mi:@	
anaesthetic	An@s'TEtIk	
anal	'EIn@l	
analgesic	An@l'dZi:zIk	
analogy	@'nAl@dZi:	
analysis	@'nAl@s@s	
anarchy	'An@ki:	
anatomy	@'nAt@mi:	
ancestor	'AnsEst@	
anchor	'ANk@	
anchorage	'ANk@rIdZ	
ancient	'EInS@nt	
and	And	
anecdote	'An@kd@Ut	
angel	'EIndZ@l	
anger	ANɡ@	
angle	ANɡ@l	
angry	ANɡri:	
anguish	ANɡwIS	
animal	'An@m@l	
animated	'An@mEIt@d	
animosity	An@'mOs@ti:	
ankle	'ANk@l	
annex	'AnEks	
annexe	'AnEks	
annihilate	@'na:I@lEIt	
anniversary	An@'v@:s@ri:	
announce	@'na:Uns	
annoy	@'no:I	
annual	'Anju:@l	
anonymous	@'nOn@m@s	
another	@'naD@	
answer	'Ans@	
ant	Ant	
antagonise	An'tAɡ@na:Iz	
antagonistic	AntAɡ@'nIstIk	
antenna	An'tEn@	
anthem	'AnT@m	
anthropologist	AnTr@'pOl@dZ@st	
anti-	'Anti:	
antibiotic	Anti:ba:I'OtIk	
anticipate	An'tIs@pEIt	
anticlockwise	Anti:'klOkwa:Iz	
antics	'AntIks	
antidote	'Anti:d@Ut	
antihistamine	Anti:'hIst@mi:n	
antipathy	An'tIp@Ti:	
antipodes	An'tIp@di:z	
antiquated	'Ant@kwEIt@d	
antique	An'ti:k	
antiseptic	Ant@'sEptIk	
antithesis	An'tIT@s@s	
antler	'Antl@	
antonym	'Ant@nIm	
anus	'EIn@s	
anxious	'ANS@s	'ANkS@s
any	'Eni:	
anybody	'Eni:bOdi:	
anyhow	'Eni:ha:U	
anyone	'Eni:wan	
anything	'Eni:TIN	
anyway	'Eni:wEI	
anywhere	'Eni:wE@	
anzac	'AnzAk	
apart	@'pa:t	
apartheid	@'pa:tEIt	@'pa:ta:It
apartment	@pa:tm@nt	
apartments	@pa:tm@nts	
apathy	'Ap@Ti:	
ape	EIp	
apex	'EIpEks	
apocalypse	@'pOk@lIps	
apologise	@'pOl@dZa:Iz	
apology	@'pOl@dZi:	
apostle	@'pOs@l	
apostrophe	@'pOstr@fi:	
appal	@'po:l	
apparatus	Ap@'ra:t@s	
apparent	@'pAr@nt	
apparition	Ap@'rIS@n	
appeal	@'pi:l	
appear	@'pI@	
appearance	@'pI@r@ns	
appease	@'pi:z	
append	@'pEnd	
appendicitis	@pEnd@'sa:It@s	
appendix	@'pEndIks	
appetising	'Ap@ta:IzIN	
appetite	'Ap@ta:It	
applause	@'plo:z	
apple	Ap@l	
appliance	@'pla:I@ns	
applicable	@'plIk@b@l	
applicant	'Apl@k@nt	
apply	@'pla:I	
appoint	@'po:Int	
appointment	@'po:Intm@nt	
appreciate	@'pri:Si:EIt	
apprehend	Apr@'hEnd	
apprehension	Apr@'hEnS@n	
apprentice	@'prEnt@s	
approach	@'pr@UtS	
approachable	@'pr@UtS@b@l	
appropriate	@'pr@Upri:@t	
approval	@'pru:v@l	
approve	@'pru:v	
approximate	@'prOks@m@t	
april	'EIpr@l	
apron	'EIpr@n	
apt	Apt	
aptitude	'Apt@tSu:d	
aquarium	@'kwE@ri:@m	
arabic	'Ar@bIk	
arbitrary	'a:b@tr@ri:	
arbitration	a:b@'trEIS@n	
arc	a:k	
arcade	a:'kEId	
arch	a:tS	
archaeologist	a:ki:'Ol@dZ@st	
archaic	a:'kEIIk	
architect	'a:k@tEkt	
arcticcircle	a:ktIk's@:k@l	
arduous	'a:dZu:@s	
are	a:	
area	E@ri:@	
arena	@ri:n@	
arguable	a:ɡju:@b@l	
argue	a:ɡju:	
argument	a:ɡj@m@nt	
arise	@'ra:Iz	
aristocracy	Ar@'stOkr@si:	
arithmetic	@'rITm@tIk	
ark	a:k	
arm	a:m	
armchair	'a:mtSE@	
armed	a:md	
armful	'a:mfUl	
armhole	'a:mh@Ul	
armistice	'a:m@st@s	
armour	'a:m@	
armpit	'a:mpIt	
army	'a:mi:	
aroma	@'r@Um@	
around	@'ra:Und	
arousal	@'ra:Uz@l	
arouse	@'ra:Uz	
arrange	@'rEIndZ	
arrangement	@'rEIndZm@nt	
array	@'rEI	
arrest	@'rEst	
arrival	@'ra:Iv@l	
arrive	@'ra:Iv	
arrogant	Ar@ɡ@nt	
arrow	'Ar@U	
arse	a:s	
arsenal	'a:s@n@l	
arsenic	'a:s@nIk	
arson	'a:s@n	
art	a:t	
artunion	'a:tju:nj@n	
artery	'a:t@ri:	
arthritis	a:'Tra:It@s	
article	'a:tIk@l	
artificial	a:t@'fIS@l	
artist	'a:t@st	
arvo	'a:v@U	
as	Az	
asbestos	@s'bEst@s	
ascend	@'sEnd	
ascent	@'sEnt	
ascertain	As@'tEIn	
ash	AS	
ashamed	@'SEImd	
aside	@'sa:Id	
ask	a:sk	
asleep	@'sli:p	
asparagus	@'spAr@ɡ@s	
aspect	'AspEkt	
asphalt	'ASfElt	
aspire	@'spa:I@	
aspirin	'Aspr@n	
ass	As	
assassin	@'sAs@n	
assassinate	@'sAs@nEIt	
assault	@'sOlt	
assemble	@'sEmb@l	
assembly	@'sEmbli:	
assent	@'sEnt	
assert	@'s@:t	
assertive	@'s@:tIv	
assess	@'sEs	
asset	'AsEt	
assign	@'sa:In	
assignment	@'sa:Inm@nt	
assimilate	@'sIm@lEIt	
assist	@'sIst	
associate	@'s@USi:EIt	@'s@Usi:EIt
association	@s@Usi:'EIS@n	
assortment	@'so:tm@nt	
assume	@'sju:m	
assurance	@'So:r@ns	
assure	@'So:	
asterisk	'Ast@rIsk	
asthma	'Asm@	
astonish	@'stOnIS	
astound	@'sta:Und	
astray	@'strEI	
astrology	@s'trOl@dZi:	
astronaut	'Astr@no:t	
astronomy	@s'trOn@mi:	
astute	@s'tju:t	
asylum	@'sa:Il@m	
at	At	
ate	EIt	
atheist	'EITi:@st	
athlete	'ATli:t	
atlas	'Atl@s	
atm	EIti:'Em	
atmosphere	'Atm@sfI@	
atom	'At@m	
atomic	@'tOmIk	
atrocious	@'tr@US@s	
attach	@'tAtS	
attack	@'tAk	
attain	@'tEIn	
attempt	@'tEmpt	
attend	@'tEnd	
attention	@'tEnS@n	
attic	'AtIk	
attire	@'ta:I@	
attitude	'At@tju:d	
attract	@'trAkt	
attractive	@'trAktIv	
attribute	@'trIbju:t	'Atr@bju:t
atypical	EI'tIpIk@l	
aubergine	'@Ub@Zi:n	
auburn	'o:b@n	
auction	'OkS@n	
audacious	o:'dEIS@s	
audible	'o:d@b@l	
audience	'o:di:@ns	
audio	'o:di:@U	
audit	'o:d@t	
audition	o:'dIS@n	
aug	o:ɡ@st	
august	o:'ɡast	'o:ɡ@st
aunt	a:nt	
aura	'o:r@	
auspicious	o:'spIS@s	
austere	Os'tI@	
australia	@strEIli:@	
australian	@st'rEIlj@n	
australiandemocrats	@strEIlj@n'dEm@krAts	
australianlaborparty	@strEIlj@n'lEIb@pa:ti:	
authentic	o:'TEntIk	
author	'o:T@	
authorise	'o:T@ra:Iz	
authority	o:'TOr@ti:	
autobiography	o:t@Uba:I'Oɡr@fi:	
autograph	o:t@ɡrAf	
automatic	o:t@'mAtIk	
automobile	'o:t@m@bi:l	
autonomous	o:'tOn@m@s	
autopsy	'o:tOpsi:	
autumn	'o:t@m	
auxiliary	Oɡ'zIlj@ri:	
avail	@'vEIl	
available	@'vEIl@b@l	
avalanche	'Av@lAnS	'Av@lAntS
ave	'Av@nju:	
avenge	@'vEndZ	
avenue	Av@nju:	
average	'AvrIdZ	
averse	@'v@:s	
aversion	@'v@:Z@n	
avert	@'v@:t	
aviation	EIvi:'EIS@n	
avid	'Av@d	
avocado	Av@'ka:d@U	
avoid	@'vo:Id	
await	@'wEIt	
awake	@'wEIk	
awaken	@'wEIk@n	
award	@'wo:d	
aware	@'wE@	
away	@'wEI	
awe	o:	
awful	'o:f@l	
awhile	@'wa:Il	
awkward	'o:kw@d	
awning	'o:nIN	
axe	Aks	
axis	'Aks@s	
axle	'Aks@l	
B	bi:	
babble	'bAb@l	
baby	'bEIbi:	
babysit	'bEIbi:sIt	
bachelor	'bAtS@l@	
back	bAk	
backbone	'bAkb@Un	
backdate	'bAkdEIt	
backfire	'bAkfa:I@	
background	bAkɡra:Und	
backing	'bAkIN	
backlog	bAklOɡ	
backside	'bAksa:Id	
backstop	'bAkstOp	
backstroke	'bAkstr@Uk	
backup	'bAkap	
backward	'bAkw@d	
backwards	'bAkw@dz	
backyard	bAk'ja:d	
bacon	'bEIk@n	
bacteria	bAk'tI@ri:@	
bad	bAd	
bade	bAd	
badge	bAdZ	
badger	'bAdZ@	
baffle	'bAfl	
bag	bAɡ	
baggage	bAɡIdZ	
bahasaindonesia	b@ha:s@Ind@'ni:Z@	
bail	bEIl	
bait	bEIt	
bake	bEIk	
bakingpowder	'bEIkINpa:Ud@	
bakingsoda	'bEIkINs@Ud@	
balance	'bAl@ns	
balanced	'bAl@nst	
balcony	'bAlk@ni:	
bald	bo:ld	
bale	bEIl	
ballast	'bAl@st	
ballet	'bAlEI	
ballot	'bAl@t	
ballpointpen	bo:lpo:Int'pEn	
balmy	'ba:mi:	
bamboozle	bAm'bu:z@l	
ban	bAn	
band	bAnd	
bandaid	'bAndEId	
bandicoot	'bAndi:ku:t	
bandit	'bAnd@t	
bang	bAN	
banjo	'bAndZ@U	
bank	bANk	
bankrupt	'bANkrapt	
banksia	'bANksi:@	
banner	'bAn@	
banquet	'bANkw@t	
baptism	'bAptIz@m	
bar	ba:	
barcode	'ba:k@Ud	
barb	ba:b	
barbarian	ba:'bE@ri:@n	
barbecue	'ba:b@kju:	
barber	'ba:b@	
barbiturate	ba:'bItSUr@t	ba:'bItS@r@t
bare	bE@	
barely	'bE@li:	
bargain	ba:ɡ@n	
barge	ba:dZ	
baritone	'bAr@t@Un	
bark	ba:k	
barn	ba:n	
barometer	b@'rOm@t@	
barrack	'bAr@k	
barracks	'bAr@ks	
barrage	'bAra:Z	
barrel	'bAr@l	
barren	'bAr@n	
barrier	'bAri:@	
barrister	'bAr@st@	
barrow	'bAr@U	
base	bEIs	
baseball	'bEIsbo:l	
basement	'bEIsm@nt	
bash	bAS	
bashful	'bASfUl	
basic	'bEIsIk	
basin	'bEIs@n	
basis	'bEIs@s	
bask	ba:sk	
basket	'ba:sk@t	
basketball	'ba:sk@tbo:l	
bass	bEIs	
bassinette	bAs@'nEt	
bastard	'ba:st@d	
bat	bAt	
batch	bAtS	
bath	ba:T	
bathe	bEID	
bathers	'bEID@z	
bathroom	'ba:Tru:m	
baton	'bAt@n	
battalion	b@'tAlj@n	
batten	'bAt@n	
batter	'bAt@	
battle	bAt@l	
baulk	bo:k	
bawdy	'bo:di:	
bawl	bo:l	
bay	bEI	
bayonet	'bEI@nEt	
bbq	'ba:b@kju:	
bc	bi:'si:	
be	bi:	
beach	bi:tS	
beachinspector	'bi:tSInspEkt@	
beacon	'bi:k@n	
bead	bi:d	
beak	bi:k	
beam	bi:m	
bean	bi:n	
bear	bE@	
beard	bI@d	
bearing	'bE@rIN	
beast	bi:st	
beat	bi:t	
beaut	bju:t	
beautician	bju:'tIS@n	
beautiful	'bju:t@f@l	
beauty	'bju:ti:	
became	b@'kEIm	
because	bi:'ko:z	
beckon	'bEk@n	
become	b@'kam	
becoming	b@'kamIN	
bed	bEd	
bedding	'bEdIN	
bedraggled	b@'drAɡ@ld	
bedridden	'bEdrId@n	
bedroom	'bEdru:m	
bee	bi:	
beef	bi:f	
been	bi:n	
beer	bI@	
before	b@'fo:	
befriend	b@'frEnd	
beg	bEɡ	
began	b@'ɡAn	
begin	b@'ɡIn	
beginner	b@'ɡIn@	
begrudge	b@'ɡradZ	
begun	b@'ɡan	
behalf	b@'ha:f	
behave	b@'hEIv	
behind	b@'ha:Ind	
beige	bEIZ	
being	'bi:IN	
belated	b@'lEIt@d	
belch	bEltS	
belief	b@'li:f	
believe	b@'li:v	
belittle	b@'lIt@l	
bell	bEl	
belligerent	b@'lIdZ@r@nt	
bellow	'bEl@U	
belly	'bEli:	
bellybutton	'bEli:bat@n	
belong	b@'lON	
belongings	b@'lONINz	
beloved	b@'lav@d	
below	b@'l@U	
belt	bElt	
bench	bEntS	
bend	bEnd	
beneath	b@'ni:T	
benefactor	'bEn@fAkt@	
beneficial	bEn@'fIS@l	
beneficiary	bEn@'fIS@ri:	
benefit	'bEn@f@t	
benevolent	b@'nEv@l@nt	
benign	b@'na:In	
bent	bEnt	
bequeath	b@'kwi:D	
bereaved	b@'ri:vd	
bereft	b@'rEft	
beret	'bErEI	
berry	'bEri:	
berserk	b@'z@:k	
berth	b@:T	
beside	b@'sa:Id	
besides	b@'sa:Idz	
besiege	b@'si:dZ	
best	bEst	
bestman	bEst'mAn	
bet	bEt	
betray	b@'trEI	
better	'bEt@	
between	b@'twi:n	
beverage	'bEvrIdZ	
beware	b@'wE@	
bewildered	b@'wIld@d	
bewitch	b@'wItS	
beyond	b@'jOnd	bi:'Ond
biannual	ba:I'Anju:@l	
bias	'ba:I@s	
bib	bIb	
bible	'ba:Ib@l	
bibliography	bIbli:'Oɡr@fi:	
bicentenary	ba:IsEn'ti:n@ri:	ba:IsEn'tEn@ri:
bicentennial	ba:Is@n'tEni:@l	ba:IsEn'tEni:@l
biceps	'ba:IsEps	
bicker	'bIk@	
bicycle	'ba:IsIk@l	
bid	bId	
bide	ba:Id	
biennial	ba:I'Eni:@l	
bifocals	ba:I'f@Uk@lz	
big	bIɡ	
bigamy	bIɡ@mi:	
biggie	bIɡi:	
bight	ba:It	
bigot	bIɡ@t	
bike	ba:Ik	
bikini	b@'ki:ni:	
bile	ba:Il	
bilingual	ba:I'lINɡw@l	
bilious	'bIlj@s	
bill	bIl	
billabong	'bIl@bON	
billboard	'bIlbo:d	
billet	'bIl@t	
billiards	'bIlj@dz	
billion	'bIlj@n	
billow	'bIl@U	
billy	'bIli:	
bin	bIn	
bind	ba:Ind	
bindi-eye	'bIndi:-a:I	
bingo	bINɡ@U	
binoculars	b@'nOkj@l@z	
biodegradable	ba:I@Ud@'ɡrEId@b@l	
biography	ba:I'Oɡr@fi:	
biologist	ba:I'Ol@dZ@st	
biopsy	'ba:IOpsi:	
bird	b@:d	
biro	'ba:Ir@U	
birth	b@:T	
birthday	'b@:TdEI	
biscuit	'bIsk@t	
bisect	ba:I'sEkt	
bisexual	ba:I'sEkSu:@l	
bishop	'bIS@p	
bistro	'bIstr@U	
bit	bIt	
bitch	bItS	
bite	ba:It	
bitter	'bIt@	
bitumen	'bItS@m@n	
bivouac	'bIvu:Ak	
bizarre	b@'za:	
blab	blAb	
black	blAk	
blacksheep	blAk'Si:p	
blackboard	'blAkbo:d	
blackhead	'blAkhEd	
blackmail	'blAkmEIl	
blackout	'blAka:Ut	
blacksmith	'blAksmIT	
bladder	'blAd@	
blade	blEId	
blame	blEIm	
bland	blAnd	
blank	blANk	
blanket	'blANk@t	
blare	blE@	
blaspheme	blAs'fi:m	
blast	bla:st	
blatant	'blEIt@nt	
blaze	blEIz	
blazer	'blEIz@	
bleach	bli:tS	
bleak	bli:k	
bleary	'blI@ri:	
bleat	bli:t	
bleed	bli:d	
blemish	'blEmIS	
blend	blEnd	
blender	'blEnd@	
bless	blEs	
blessing	'blEsIN	
blew	blu:	
blight	bla:It	
blind	bla:Ind	
blindfold	'bla:Indf@Uld	
blink	blINk	
blinker	'blINk@	
bliss	blIs	
blister	'blIst@	
blistering	'blIst@rIN	
blitz	blIts	
blizzard	'blIz@d	
bloated	'bl@Ut@d	
bloc	blOk	
block	blOk	
blockade	blO'kEId	
blockbuster	'blOkbast@	
bloke	bl@Uk	
blond	blOnd	
blonde	blOnd	
blood	blad	
bloodbath	'bladba:T	
bloodshed	'bladSEd	
bloodshot	'bladSOt	
bloodstream	'bladstri:m	
bloodthirsty	'bladT@:sti:	
bloody	'bladi:	
bloody-minded	bladi:-'ma:Ind@d	
bloom	blu:m	
blossom	'blOs@m	
blot	blOt	
blouse	bla:Uz	
blow	bl@U	
blowout	'bl@Ua:Ut	
blowtorch	'bl@Uto:tS	
blubber	'blab@	
bludge	bladZ	
bludgeon	'bladZ@n	
blue	blu:	
bluemetal	blu:'mEt@l	
bluemovie	blu:'mu:vi:	
blue-collar	'blu:-kOl@	
blue-ringedoctopus	blu:-rINd'Okt@pUs	
bluebird	blu:b@:d	
bluebottle	'blu:bOt@l	
blueprint	'blu:prInt	
blues	blu:z	
bluff	blaf	
blunder	'bland@	
blunt	blant	
blur	bl@:	
blurb	bl@:b	
blurt	bl@:t	
blush	blaS	
bluster	'blast@	
bmx	bi:Em'Eks	
board	bo:d	
boarder	'bo:d@	
boast	b@Ust	
boat	b@Ut	
boatpeople	'b@Utpi:p@l	
bob	bOb	
bobbin	'bOb@n	
bobbypin	'bObi:pIn	
bodice	'bOd@s	
body	'bOdi:	
bodyguard	bOdi:ɡa:d	
bog	bOɡ	
bogus	b@Uɡ@s	
bogy	b@Uɡi:	
boil	bo:Il	
boiler	'bo:Il@	
boilersuit	'bo:Il@su:t	
boisterous	'bo:Istr@s	
bold	b@Uld	
bolster	'b@Ulst@	
bolt	b@Ult	
bomb	bOm	
bombard	bOm'ba:d	
bombshell	'bOmSEl	
bonafide	b@Un@'fa:Idi:	
bond	bOnd	
bone	b@Un	
bonfire	'bOnfa:I@	
bongo	bONɡ@U	
bonnet	'bOn@t	
bonus	'b@Un@s	
boob	bu:b	
boobook	'bu:bUk	
boobyprize	'bu:bi:pra:Iz	
boobytrap	'bu:bi:trAp	
book	bUk	
bookcase	'bUkkEIs	
bookkeeping	'bUkki:pIN	
bookmaker	'bUkmEIk@	
bookstall	'bUksto:l	
bookworm	'bUkw@:m	
boom	bu:m	
boomer	'bu:m@	
boomerang	'bu:m@rAN	
boon	bu:n	
boor	bo:	
boost	bu:st	
boot	bu:t	
booth	bu:D	
booty	'bu:ti:	
booze	bu:z	
border	'bo:d@	
borderline	'bo:d@la:In	
bore	bo:	
born	bo:n	
borne	bo:n	
boronia	b@'r@Uni:@	
borough	'bar@	
borrow	'bOr@U	
bosom	'bUz@m	
boss	bOs	
botanist	'bOt@n@st	
botch	bOtS	
both	b@UT	
bother	'bOD@	
bottle	'bOt@l	
bottlebrush	'bOt@lbraS	
bottleneck	'bOt@lnEk	
bottom	'bOt@m	
bough	ba:U	
bought	bo:t	
boulder	'b@Uld@	
boulevard	'bu:l@va:d	
bounce	ba:Uns	
bouncing	'ba:UnsIN	
bouncy	'ba:Unsi:	
bound	ba:Und	
boundary	'ba:Undri:	
bounty	'ba:Unti:	
bouquet	bu:'kEI	b@U'kEI
bourgeois	'bU@Zwa:	
bout	ba:Ut	
boutique	bu:'ti:k	
bow	b@U	
bowel	'ba:U@l	'ba:Ul
bowerbird	'ba:U@b@:d	
bowl	b@Ul	
bowling	'b@UlIN	
bowls	b@Ulz	
bowser	'ba:Uz@	
box	bOks	
boxjellyfish	bOks'dZEli:fIS	
boxoffice	'bOksOf@s	
boxer	'bOks@	
boy	bo:I	
boycott	'bo:IkOt	
boyfriend	'bo:IfrEnd	
bra	bra:	
brace	brEIs	
bracelet	'brEIsl@t	
bracken	'brAk@n	
bracket	'brAk@t	
brag	brAɡ	
braid	brEId	
braille	brEIl	
brain	brEIn	
brainstorm	'brEInsto:m	
brainwash	'brEInwOS	
brainwave	'brEInwEIv	
braise	brEIz	
brake	brEIk	
bran	brAn	
branch	brAntS	
brand	brAnd	
brash	brAS	
brass	bra:s	
brassiere	'brAzi:@	br@'zI@
brat	brAt	
bravado	br@'va:d@U	
brave	brEIv	
brawl	bro:l	
brawn	bro:n	
brazen	'brEIz@n	
breach	bri:tS	
bread	brEd	
bread-and-butter	brEd-@n-'bat@	
breadline	'brEdla:In	
breadth	brEdT	
breadwinner	'brEdwIn@	
break	brEIk	
break-in	'brEIk-In	
breakable	'brEIk@b@l	
breakdown	'brEIkda:Un	
breakfast	'brEkf@st	
breakthrough	'brEIkTru:	
bream	brIm	
breast	brEst	
breaststroke	'brEststr@Uk	
breath	brET	
breathtest	'brETtEst	
breathalyser	'brET@la:Iz@	
breathe	bri:D	
breathtaking	'brETtEIkIN	
breed	bri:d	
breeze	bri:z	
breezy	'bri:zi:	
brevity	'brEv@ti:	
brew	bru:	
brewery	'bru:@ri:	
bribe	bra:Ib	
brick	brIk	
brick-veneer	brIk-v@'nI@	
brickie	'brIki:	
bricklayer	'brIklEI@	
bride	bra:Id	
bridegroom	bra:Idɡru:m	
bridesmaid	'bra:IdzmEId	
bridge	brIdZ	
bridle	'bra:Id@l	
brief	bri:f	
briefcase	'bri:fkEIs	
bright	bra:It	
brilliant	'brIlj@nt	
brim	brIm	
brine	bra:In	
bring	brIN	
brink	brINk	
brisk	brIsk	
bristle	'brIs@l	
brittle	'brIt@l	
broach	br@UtS	
broad	bro:d	
broad-minded	bro:d-'ma:Ind@d	
broadcast	'bro:dka:st	
broccoli	'brOk@li:	
brochure	'br@US@	
broke	br@Uk	
broken	'br@Uk@n	
broker	'br@Uk@	
brolga	brOlɡ@	
brolly	'brOli:	
bronchitis	brON'ka:It@s	
bronze	brOnz	
brooch	br@UtS	
brood	bru:d	
broom	bru:m	
bros	'braD@z	
broth	brOT	
brothel	'brOT@l	
brother	'braD@	
brother-in-law	'braD@r-In-lo:	
brought	bro:t	
brow	bra:U	
browbeat	'bra:Ubi:t	
brown	bra:Un	
browse	bra:Uz	
bruise	bru:z	
brumby	'brambi:	
brunch	brantS	
brunette	bru:'nEt	
brunt	brant	
brush	braS	
brusselssprout	bras@lz'spra:Ut	
brutal	'bru:t@l	
brute	bru:t	
bubble	'bab@l	
bubbler	'babl@	
buck	bak	
bucket	'bak@t	
buckle	'bak@l	
bucktooth	bak'tu:T	
bud	bad	
buddhism	'bUdIz@m	
buddy	'badi:	
budge	badZ	
budgerigar	badZ@ri:ɡa:	
budget	'badZ@t	
budgie	'badZi:	
buff	baf	
buffer	'baf@	
buffet	'bafEI	
buffoon	b@'fu:n	
bug	baɡ	
bugbear	baɡbE@	
bugger	baɡ@	
bugle	bju:ɡ@l	
build	bIld	
building	bIldIN	
buildingsociety	'bIldINs@sa:I@ti:	
built-uparea	bIlt-ap'E@ri:@	
bulb	balb	
bulge	baldZ	
bulk	balk	
bull	bUl	
bullbar	'bUlba:	
bulldozer	'bUld@Uz@	
bullet	'bUl@t	
bulletin	'bUl@t@n	
bullion	'bUlj@n	
bullock	'bUl@k	
bullseye	'bUlza:I	
bullshit	'bUlSIt	
bully	'bUli:	
bum	bam	
bumble	'bamb@l	
bump	bamp	
bumper	'bamp@	
bun	ban	
bunch	bantS	
bundle	'band@l	
bundy	'bandi:	
bung	baN	
bungalow	baNɡ@l@U	
bungle	baNɡ@l	
bunion	'banj@n	
bunk	baNk	
bunker	'baNk@	
bunny	'bani:	
bunyip	'banj@p	
buoy	bo:I	
buoyant	'bo:I@nt	
burble	'b@:b@l	
burden	'b@:d@n	
bureau	'bju:r@U	
bureaucracy	bju:'rOkr@si:	
bureaucrat	'bju:r@krAt	
burglar	b@:ɡl@	
burial	'bEri:@l	
burl	b@:l	
burly	'b@:li:	
burn	b@:n	
burnish	'b@:nIS	
burp	b@:p	
burr	b@:	
burrow	'bar@U	
bursar	'b@:s@	
bursary	'b@:s@ri:	
burst	b@:st	
bury	'bEri:	
bus	bas	
bush	bUS	
bushband	'bUSbAnd	
bushed	bUSt	
bushfire	'bUSfa:I@	
bushie	'bUSi:	
bushman	'bUSm@n	
bushranger	'bUSrEIndZ@	
bushwalk	'bUSwo:k	
bushwhacker	'bUSwAk@	
business	'bIzn@s	
businesslike	'bIzn@sla:Ik	
busker	'bask@	
bust	bast	
bustard	'bast@d	
bustle	'bas@l	
busy	'bIzi:	
busybody	'bIzi:bOdi:	
but	bat	
butane	'bju:tEIn	
butch	bUtS	
butcher	'bUtS@	
butcherbird	'bUtS@b@:d	
butt	bat	
butter	'bat@	
butterflystroke	'bat@fla:Istr@Uk	
buttocks	'bat@ks	
button	bat@n	
buttress	'batr@s	
buy	ba:I	
buzz	baz	
by	ba:I	
by-election	'ba:I-@lEkS@n	
by-law	'ba:I-lo:	
by-product	'ba:I-prOdakt	
bye	ba:I	
byo	bi:wa:I'@U	
bypass	'ba:Ipa:s	
bystander	'ba:IstAnd@	
byte	ba:It	
byword	'ba:Iw@:d	
c	si:	
c/o	'kE@rOv	
cab	kAb	
cabbage	'kAbIdZ	
cabin	'kAb@n	
cabinet	'kAbn@t	
cable	'kEIb@l	
cackle	'kAk@l	
cadet	k@'dEt	
cadge	kAdZ	
caesareansection	s@;zE@ri:@n'sEkS@n	
cafe	'kAfEI	
cafeteria	kAf@'tI@ri:@	
cage	kEIdZ	
cagey	'kEIdZi:	
cake	kEIk	
calamari	kAl@'ma:ri:	
calamity	k@'lAm@ti:	
calcium	'kAlsi:@m	
calculate	'kAlkj@lEIt	
calculating	'kAlkj@lEItIN	
calculator	'kAlkj@lEIt@	
calendar	'kAl@nd@	
calf	ka:f	
call	ko:l	
callgirl	ko:lɡ@:l	
callous	'kAl@s	
calm	ka:m	
calorie	'kAl@ri:	
came	kEIm	
camera	'kAmr@	
camouflage	'kAm@fla:Z	
camp	kAmp	
campaign	kAm'pEIn	
campus	'kAmp@s	
can	kAn	
canal	k@'nAl	
cancel	'kAns@l	
cancer	'kAns@	
candid	'kAnd@d	
candidate	'kAnd@dEIt	
candle	'kAnd@l	
candour	'kAnd@	
cane	kEIn	
canetoad	'kEInt@Ud	
canine	'kEIna:In	
cannabis	'kAn@b@s	
cannon	'kAn@n	
cannot	'kAnOt	
canoe	k@'nu:	
canopy	'kAn@pi:	
cant	ka:nt	
canteen	kAn'ti:n	
canter	'kAnt@	
cantonese	kAnt@'ni:z	
canvas	'kAnv@s	
canyon	'kAnj@n	
cap	kAp	
capable	'kEIp@b@l	
capacity	k@'pAs@ti:	
cape	kEIp	
capital	'kAp@t@l	
capitalise	'kAp@t@la:Iz	
capitalism	'kAp@t@lIz@m	
capsicum	'kAps@k@m	'kApsi:k@m
capsize	kAp'sa:Iz	
capsule	'kApSu:l	
captain	'kApt@n	
caption	'kApS@n	
captivate	'kApt@vEIt	
captive	'kAptIv	
captivity	kAp'tIv@ti:	
capture	'kAptS@	
car	ka:	
carpark	'ka:pa:k	
carafe	k@'ra:f	
caramel	'kAr@m@l	
carat	'kAr@t	
caravan	'kAr@vAn	
carbohydrate	ka:b@'ha:IdrEIt	
carbon	'ka:b@n	
carburettor	ka:bj@'rEt@	
carcass	'ka:k@s	
carcinogen	ka:'sIn@dZ@n	
card	ka:d	
cardboard	'ka:dbo:d	
cardiac	'ka:di:Ak	
cardigan	ka:dIɡ@n	
cardinalnumber	ka:d@n@l'namb@	
care	kE@	
career	k@'rI@	
careful	'kE@f@l	
careless	'kE@l@s	
caress	k@'rEs	
caretaker	'kE@tEIk@	
cargo	ka:ɡ@U	
caricature	'kAr@k@tSU@	
carnage	'ka:nIdZ	
carnival	'ka:n@v@l	
carol	'kAr@l	
carpenter	'ka:p@nt@	
carpet	'ka:p@t	
carriage	'kArIdZ	
carry	'kAri:	
cart	ka:t	
cartilage	'ka:t@lIdZ	
carton	'ka:t@n	
cartoon	ka:'tu:n	
cartridge	'ka:trIdZ	
carts	ka:ts	
carve	ka:v	
case	kEIs	
cash	kAS	
cashier	kAS'I@	
casino	k@'si:n@U	
cask	ka:sk	
casserole	'kAs@r@Ul	
cassette	k@'sEt	
cast	ka:st	
caste	ka:st	
castle	ka:s@l	
castor	'ka:st@	
castrate	'kAstrEIt	
casual	'kAZju:@l	'kAZu:@l
casualty	'kAZju:@lti:	'kAZu:@lti:
casuarina	kAZj@'ri:n@	
cat	kAt	
catalogue	kAt@lOɡ	
catapult	'kAt@palt	
cataract	'kAt@rAkt	
catarrh	k@'ta:	
catastrophe	k@'tAstr@fi:	
catch	kAtS	
category	kAt@ɡ@ri:	'kAt@ɡri:
cater	'kEIt@	
cathedral	k@'Ti:dr@l	
cattle	'kAt@l	
caucus	'ko:k@s	
caught	ko:t	
cauliflower	'kOli:fla:U@	
cause	ko:z	
causeway	'ko:zwEI	
caustic	'kOstIk	
cauterise	'ko:t@ra:Iz	
cautious	'ko:S@s	
cavalry	'kAv@lri:	
cave	kEIv	
cavern	'kAv@n	
cavity	'kAv@ti:	
cd	si:'di:	
cease	si:s	
ceasefire	'si:sfa:I@	
ceiling	'si:lIN	
celebrate	'sEl@brEIt	
celebrated	'sEl@brEIt@d	
celebrity	s@'lEbr@ti:	
celery	'sEl@ri:	
celibacy	'sEl@b@si:	
cell	sEl	
cellar	'sEl@	
celsius	'sElsi:@s	
cement	s@'mEnt	
cemetery	'sEm@tri:	
censor	'sEns@	
censure	'sEnS@	
census	'sEns@s	
cent	sEnt	
centenary	sEn'ti:n@ri:	sEn'tEn@ri:
centigrade	sEnt@ɡrEId	
centimetre	'sEnt@mi:t@	
central	'sEntr@l	
centre	'sEnt@	
century	'sEntS@ri:	
ceramic	s@'rAmIk	
cereal	'sI@ri:@l	
cerebral	'sEr@br@l	
ceremony	'sEr@m@ni:	
certain	's@:t@n	
certainly	's@:t@nli:	
certificate	s@'tIfIk@t	
certify	's@:t@fa:I	
cervix	's@:vIks	
ces	si:i:'Es	
chafe	tSEIf	
chain	tSEIn	
chainsaw	'tSEInso:	
chair	tSE@	
chairman	'tSE@m@n	
chairperson	'tSE@p@:s@n	
chalk	tSo:k	
challenge	'tSAl@ndZ	
chamber	'tSEImb@	
chamois	'SAmi:	
champion	'tSAmpi:@n	
chance	tSAns	
change	tSEIndZ	
channel	'tSAn@l	
chant	tSAnt	
chaos	'kEIOs	
chap	tSAp	
chapel	'tSAp@l	
chapped	tSApt	
chapter	'tSApt@	
character	'kAr@kt@	
characteristic	kAr@kt@'rIstIk	
charade	S@'ra:d	S@'rEId
charcoal	'tSa:k@Ul	
charge	tSa:dZ	
charisma	k@'rIzm@	
charity	'tSAr@ti:	
charm	tSa:m	
chart	tSa:t	
charter	'tSa:t@	
chase	tSEIs	
chassis	'SAzi:	
chat	tSAt	
chatter	'tSAt@	
chauffeur	'S@Uf@	
chauvinism	'S@Uv@nIz@m	
cheap	tSi:p	
cheat	tSi:t	
check	tSEk	
check-up	'tSEk-ap	
checkout	'tSEka:Ut	
cheek	tSi:k	
cheer	tSI@	
cheerful	'tSI@fUl	
cheese	tSi:z	
chef	SEf	
chemical	'kEmIk@l	
chemist	'kEm@st	
chemistry	'kEm@stri:	
chemotherapy	kEm@U'TEr@pi:	ki:m@U'TEr@pi:
cheque	tSEk	
chequebook	'tSEkbUk	
cherish	'tSErIS	
cherub	'tSEr@b	
chess	tSEs	
chest	tSEst	
chew	tSu:	
chewinggum	tSu:INɡam	
chic	Si:k	
chick	tSIk	
chicken	'tSIk@n	
chickenpox	'tSIk@npOks	
chief	tSi:f	
child	tSa:Ild	
childish	'tSa:IldIS	
chill	tSIl	
chilli	'tSIli:	
chime	'tSa:Im	
chimney	tSImni:	
chin	tSIn	
china	'tSa:In@	
chinese	'tSa:Ini:z	
chip	tSIp	
chipboard	'tSIpbo:d	
chiropractor	'ka:Ir@prAkt@	
chirp	tS@:p	
chirpy	'tS@:pi:	
chisel	'tSIz@l	
chlorine	'klo:ri:n	
chocolate	'tSOkl@t	
choice	tSo:Is	
choir	'kwa:I@	
choke	tS@Uk	
cholera	'kOl@r@	
cholesterol	k@'lEst@rOl	
chook	tSUk	
choose	tSu:z	
chop	tSOp	
choppy	'tSOpi:	
chopsticks	'tSOpstIks	
chord	ko:d	
chore	tSo:	
choreographer	kOri:'Oɡr@f@	
chorus	'ko:r@s	
chose	tS@Uz	
chosen	'tS@Uz@n	
christen	'krIs@n	
christianity	krIsti:'An@ti:	
christmas	'krIsm@s	
christmasbush	'krIsm@sbUS	
chrome	kr@Um	
chronic	'krOnIk	
chronological	krOn@'lOdZIk@l	
chubby	'tSabi:	
chuck	tSak	
chuckle	'tSak@l	
chunder	'tSand@	
chunk	tSaNk	
church	tS@:tS	
churn	tS@:n	
chute	Su:t	
chutney	'tSatni:	
cider	'sa:Id@	
cigar	s@'ɡa:	
cigarette	sIɡ@'rEt	
cinema	'sIn@m@	
circle	's@:k@l	
circuit	's@:k@t	
circulate	's@:kj@lEIt	
circulation	s@:kj@'lEIS@n	
circumcise	's@:k@msa:Iz	
circumference	s@'kamf@r@ns	
circumstance	's@:k@mstAns	
circus	's@:k@s	
citizen	'sIt@z@n	
citrus	'sItr@s	
city	sIti:	
civic	'sIvIk	
civil	'sIv@l	
civilian	s@'vIlj@n	
civilisation	sIv@la:Iz'EIS@n	
civilised	'sIv@la:Izd	
cl	kl@Us	
claim	klEIm	
clairvoyant	klE@'vo:I@nt	
clam	klAm	
clamber	'klAmb@	
clammy	'klAmi:	
clamour	'klAm@	
clamp	klAmp	
clan	klAn	
clandestine	'klAnd@sta:In	
clang	klAN	
clanger	'klAN@	
clap	klAp	
clarify	'klAr@fa:I	
clarity	'klAr@ti:	
clark	kla:k	
clash	klAS	
clasp	klAsp	
class	kla:s	
classic	'klAsIk	
classify	'klAs@fa:I	
classroom	'kla:sru:m	
clatter	'klAt@	
clause	klo:z	
claustrophobia	klOstr@'f@Ubi:@	
claw	klo:	
clay	klEI	
clean	kli:n	
clear	klI@	
clearance	'klI@r@ns	
clearing	'klI@rIN	
clearway	'klI@wEI	
clench	klEntS	
clergy	'kl@:dZi:	
clerk	kla:k	
clever	'klEv@	
clich;aae	'kli:SEI	
click	klIk	
client	'kla:I@nt	
cliff	klIf	
climate	'kla:Im@t	
climax	'kla:ImAks	
climb	kla:Im	
clinch	klIntS	
cling	klIN	
clinic	'klInIk	
clip	klIp	
cloak	kl@Uk	
clock	klOk	
clockwise	'klOkwa:Iz	
clockwork	'klOkw@:k	
clog	klOɡ	
clone	kl@Un	
close	kl@Uz	
close-up	'kl@Us-ap	
clot	klOt	
cloth	klOT	
clothe	kl@UD	
clothes	kl@UDz	
clothing	'kl@UDIN	
cloud	kla:Ud	
cloudy	'kla:Udi:	
clout	kla:Ut	
clover	'kl@Uv@	
clown	kla:Un	
club	klab	
clucky	'klaki:	
clue	klu:	
clump	klamp	
clumsy	'klamzi:	
clung	klaN	
cluster	'klast@	
clutch	klatS	
clutter	'klat@	
cm	'sEnt@mi:t@	
co	'kamp@ni:	
coach	k@UtS	
coagulate	k@U'Aɡj@lEIt	
coal	k@Ul	
coalition	k@U@'lIS@n	
coarse	ko:s	
coast	k@Ust	
coastline	'k@Ustla:In	
coat	k@Ut	
coathanger	'k@UthAN@	
coating	'k@UtIN	
coax	k@Uks	
cobblestone	kOb@lst@Un	
cobweb	'kObwEb	
cocaine	k@U'kEIn	
cock	kOk	
cock-up	'kOk-ap	
cockatoo	kOk@'tu:	
cockpit	'kOkpIt	
cocktail	kOktEIl	
cocky	'kOki:	
cocoa	'k@Uk@U	
coconut	'k@Uk@nat	
cod	si:@U'di:	
code	k@Ud	
codeine	'k@Udi:n	
coerce	k@U'@:s	
coffee	'kOfi:	
coffin	'kOf@n	
cog	kOɡ	
coherent	k@U'hI@r@nt	
cohesion	k@U'hi:Z@n	
coil	ko:Il	
coin	ko:In	
coincide	k@U@n'sa:Id	
coincidence	k@U'Ins@d@ns	
coke	k@Uk	
colander	'kal@nd@	'kOl@nd@
cold	k@Uld	
cold-blooded	'k@Uld-blad@d	
coleslaw	'k@Ulslo:	
colic	'kOlIk	
collaborate	k@'lAb@rEIt	
collapse	k@'lAps	
collar	'kOl@	
collarbone	'kOl@b@Un	
collateral	k@'lAt@r@l	
colleague	kOli:ɡ	
collect	k@'lEkt	
collective	k@'lEktIv	
collector	k@'lEkt@	
college	'kOlIdZ	
collide	k@'la:Id	
cologne	k@'l@Un	
colon	'k@Ul@n	
colonel	'k@:n@l	
colony	'kOl@ni:	
colossal	k@'lOs@l	
colour	'kal@	
column	'kOl@m	
coma	'k@Um@	
comb	k@Um	
combat	'kOmbAt	
combination	kOmb@'nEIS@n	
combinationlock	kOmb@'nEIS@nlOk	
combine	k@m'ba:In	
come	kam	
comedy	'kOm@di:	
comet	'kOm@t	
comfort	'kamf@t	
comfortable	'kamft@b@l	
comic	'kOmIk	
comma	'kOm@	
command	k@'mAnd	
commando	k@'mAnd@U	
commemorate	k@'mEm@rEIt	
commence	k@'mEns	
commend	k@'mEnd	
comment	'kOmEnt	
commentary	'kOm@ntri:	
commerce	'kOm@:s	
commercial	k@'m@:S@l	
commiserate	k@'mIz@rEIt	
commission	k@'mIS@n	
commissioner	k@'mIS@n@	
commit	k@'mIt	
commitment	k@'mItm@nt	
committee	k@'mIti:	
commodity	k@'mOd@ti:	
common	'kOm@n	
commonwealth	'kOm@nwElT	
commotion	k@'m@US@n	
communal	k@'mju:n@l	
commune	'kOmju:n	
communicate	k@'mju:n@kEIt	
communication	k@mju:n@'kEIS@n	
communism	'kOmj@nIz@m	
community	k@'mju:n@ti:	
commute	k@'mju:t	
compact	'kOmpAkt	
compactdisc	kOmpAkt'dIsk	
companion	k@m'pAnj@n	
company	'kamp@ni:	
comparative	k@m'pAr@tIv	
compare	k@m'pE@	
comparison	k@m'pAr@s@n	
compartment	k@m'pa:tm@nt	
compass	'kamp@s	
compassion	k@m'pAS@n	
compatible	k@m'pAt@b@l	
compel	k@m'pEl	
compelling	k@m'pElIN	
compensate	'kOmp@nsEIt	
compere	'kOmpE@	
compete	k@m'pi:t	
competent	'kOmp@t@nt	
competition	kOmp@'tIS@n	
competitive	k@m'pEt@tIv	
compile	k@m'pa:Il	
complacent	k@m'plEIs@nt	
complain	k@m'plEIn	
complaint	k@m'plEInt	
complement	'kOmpl@m@nt	
complete	k@m'pli:t	
complex	'kOmplEks	
complexion	k@m'plEkS@n	
complicated	'kOmpl@kEIt@d	
compliment	'kOmpl@m@nt	
complimentary	kOmpl@'mEntri:	
comply	k@m'pla:I	
component	k@m'p@Un@nt	
compose	k@m'p@Uz	
compost	'kOmpOst	
compound	'kOmpa:Und	
comprehend	kOmpr@'hEnd	
compress	k@m'prEs	
comprise	k@m'pra:Iz	
compromise	'kOmpr@ma:Iz	
compulsion	k@m'palS@n	
compulsory	k@m'pals@ri:	
compute	k@m'pju:t	
computer	k@m'pju:t@	
comrade	'kOmrEId	
con	kOn	
concave	'kOnkEIv	
conceal	k@n'si:l	
concede	k@n'si:d	
conceit	k@n'si:t	
conceited	k@n'si:t@d	
conceivable	k@n'si:v@b@l	
conceive	k@n'si:v	
concentrate	'kOns@ntrEIt	
concept	'kOnsEpt	
conception	k@n'sEpS@n	
concern	k@n's@:n	
concerning	k@n's@:nIN	
concert	'kOns@t	
concession	k@n'sES@n	
conciliation	k@nsIli:'EIS@n	
concise	k@n'sa:Is	
conclude	k@N'klu:d	k@n'klu:d
concrete	'kONkri:t	
concur	k@N'k@:	k@n'k@:
concurrent	k@N'kar@nt	k@n'kar@nt
concussion	k@N'kaS@n	k@n'kaS@n
condemn	k@n'dEm	
condensation	kOnd@n'sEIS@n	kOndEn'sEIS@n
condense	k@n'dEns	
condescend	kOnd@'sEnd	
condition	k@n'dIS@n	
conditioned	k@n'dIS@nd	
condom	'kOndOm	
condone	k@n'd@Un	
conduct	k@n'dakt	
cone	k@Un	
confectionery	k@n'fEkS@nri:	
confer	k@n'f@:	
conference	'kOnfr@ns	
confess	k@n'fEs	
confide	k@n'fa:Id	
confidence	'kOnf@d@ns	
confident	'kOnf@d@nt	
confidential	kOnf@'dEnS@l	
confine	k@n'fa:In	
confirm	k@n'f@:m	
confiscate	'kOnf@skEIt	
conflict	'kOnflIkt	k@n'flIkt
conform	k@n'fo:m	
confront	k@n'frant	
confuse	k@n'fju:z	
congested	k@n'dZEst@d	
congratulate	k@n'ɡrAtS@lEIt	
congregate	kONɡr@ɡEIt	
congregation	kONɡr@'ɡEIS@n	
congress	kONɡrEs	
conjunction	k@n'dZaNkS@n	
conjunctivitis	k@ndZaNkt@'va:It@s	k@ndZaNktIv'a:It@s
conjure	'kandZ@	'kOndZ@
connect	k@'nEkt	
conquer	'kONk@	
conscience	'kOnS@ns	
conscientious	kOnSi:'EnS@s	
conscious	'kOnS@s	
conscript	'kOnskrIpt	k@n'skrIpt
consecutive	k@n'sEkj@tIv	
consent	k@n'sEnt	
consequence	'kOns@kw@ns	
conservation	kOns@'vEIS@n	
conservative	k@n's@:v@tIv	
conserve	k@n's@:v	'kOns@:v
consider	k@n'sId@	
considerable	k@n'sIdr@b@l	k@n'sId@r@b@l
considerate	k@n'sId@r@t	
consideration	k@nsId@'rEIS@n	
consist	k@n'sIst	
consistency	k@n'sIst@nsi:	
consistent	k@n'sIst@nt	
consolation	kOns@'lEIS@n	
console	k@n's@Ul	
consonant	'kOns@n@nt	
conspicuous	k@n'spIkju:@s	
conspiracy	k@n'spIr@si:	
constable	'kanst@b@l	
constant	'kOnst@nt	
constellation	kOnst@'lEIS@n	
consternation	kOnst@'nEIS@n	
constipation	kOnst@'pEIS@n	
constituency	k@n'stItju:@nsi:	
constitution	kOnst@'tju:S@n	
constrict	k@n'strIkt	
construct	k@n'strakt	
constructive	k@n'straktIv	
consul	'kOns@l	
consult	k@n'salt	
consultant	k@n'salt@nt	
consume	k@n'sju:m	
consumer	k@n'sju:m@	
contact	'kOntAkt	
contagious	k@n'tEIdZ@s	
contain	k@n'tEIn	
container	k@n'tEIn@	
contaminate	k@n'tAm@nEIt	
contemplate	'kOnt@mplEIt	
contemporary	k@n'tEmp@ri:	
contempt	k@n'tEmpt	
contend	k@n'tEnd	
content	'kOntEnt	k@n'tEnt
contest	'kOntEst	k@n'tEst
context	'kOntEkst	
continent	'kOnt@n@nt	
continual	k@n'tInju:@l	
continue	k@n'tInju:	
continuous	k@n'tInju:@s	
contour	'kOntU@	'kOntu:@
contraband	'kOntr@bAnd	
contraception	kOntr@'sEpS@n	
contraceptive	kOntr@'sEptIv	
contract	'kOntrAkt	k@n'trAkt
contradict	kOntr@'dIkt	
contrary	'kOntr@ri:	
contrast	'kOntra:st	
contribute	k@n'trIbju:t	
control	k@n'tr@Ul	
controversy	'kOntr@v@:si:	
convalescence	kOnv@'lEs@ns	
convene	k@n'vi:n	
convenience	k@n'vi:ni:@ns	
convenient	k@n'vi:ni:@nt	
convent	'kOnv@nt	
convention	k@n'vEnS@n	
conventional	k@n'vEnS@n@l	
conversation	kOnv@'sEIS@n	
converse	'kOnv@:s	
convert	k@n'v@:t	
convertible	k@n'v@:t@b@l	
convex	'kOnvEks	
convey	k@n'vEI	
convict	k@n'vIkt	
conviction	k@n'vIkS@n	
convince	k@n'vIns	
convoy	'kOnvo:I	
cook	kUk	
cookbook	'kUkbUk	
cool	ku:l	
coolabah	'ku:l@ba:	
coop	ku:p	
cooperate	k@U'Op@rEIt	
coordinate	k@U'o:d@nEIt	
cop	kOp	
cope	k@Up	
copper	'kOp@	
copy	'kOpi:	
copyright	'kOpi:ra:It	
coral	'kOr@l	
cord	ko:d	
cordial	'ko:di:@l	
corduroy	'ko:dZ@ro:I	'ko:d@ro:I
core	ko:	
cork	ko:k	
corkscrew	'ko:kskru:	
corn	ko:n	
corner	ko:n@	
cornflakes	'ko:nflEIks	
corny	'ko:ni:	
coronary	'kOr@nri:	
coronation	kOr@'nEIS@n	
coroner	'kOr@n@	
corporal	'ko:p@r@l	'ko:pr@l
corporation	ko:p@'rEIS@n	
corps	ko:	
corpse	ko:ps	
correct	k@'rEkt	
correspond	kOr@'spOnd	
corridor	'kOr@do:	
corroboree	k@'rOb@ri:	
corrode	k@'r@Ud	
corrugated	kOr@ɡEIt@d	
corrupt	k@'rapt	
cortisone	'ko:t@z@Un	
cosmetic	kOz'mEtIk	
cosmopolitan	kOzm@'pOl@t@n	
cosmos	'kOzmOs	
cossie	'kOzi:	
cost	kOst	
costume	'kOstju:m	
cosy	'k@Uzi:	
cot	kOt	
cottage	'kOtIdZ	
cotton	kOt@n	
couch	ka:UtS	
cough	kOf	
could	kUd	
council	'ka:Uns@l	
counsel	'ka:Uns@l	
count	ka:Unt	
counter	'ka:Unt@	
counterfeit	'ka:Unt@f@t	'ka:Unt@fIt
country	'kantri:	
coup	ku:	
couple	'kap@l	
coupon	'ku:pOn	
courage	'karIdZ	
courier	'kUri:@	'kU@ri:@
course	ko:s	
court	ko:t	
courteous	'k@:ti:@s	
courtyard	'ko:tja:d	
cousin	'kaz@n	
cove	k@Uv	
covenant	'kav@n@nt	
cover	'kav@	
covet	'kav@t	
cow	ka:U	
coward	'ka:U@d	
crab	krAb	
crack	krAk	
cracker	'krAk@	
crackle	'krAk@l	
crackling	'krAklIN	
cradle	'krEId@l	
craft	kra:ft	
crafty	'kra:fti:	
crag	krAɡ	
cram	krAm	
cramp	krAmp	
cramped	krAmpt	
crane	krEIn	
crank	krANk	
cranky	'krANki:	
crash	krAS	
crate	krEIt	
crater	'krEIt@	
crave	krEIv	
crawl	kro:l	
crayfish	'krEIfIS	
crayon	'krEIOn	
craze	krEIz	
crazy	'krEIzi:	
creak	kri:k	
cream	kri:m	
crease	kri:s	
create	kri:'EIt	
creature	'kri:tS@	
creche	krEIS	
credible	'krEd@b@l	
credit	'krEd@t	
creek	kri:k	
creep	kri:p	
creeper	'kri:p@	
cremate	kr@'mEIt	
crematorium	krEm@'to:ri:@m	
crepe	krEIp	
crest	krEst	
crevice	'krEv@s	
crew	kru:	
crib	krIb	
cricket	'krIk@t	
crime	kra:Im	
crimson	'krImz@n	
cringe	krIndZ	
crinkle	'krINk@l	
cripple	'krIp@l	
crisis	'kra:Is@s	
crisp	krIsp	
critic	'krItIk	
critical	'krItIk@l	
croak	kr@Uk	
croatian	kr@U'EIS@n	
crockery	'krOk@ri:	
crocodile	'krOk@da:Il	
crook	krUk	
crooked	'krUk@d	
croon	kru:n	
crop	krOp	
cross	krOs	
cross-examine	krOs-Eɡ'zAm@n	
crossroads	'krOsr@Udz	
crossword	'krOsw@:d	
crouch	kra:UtS	
croupier	'kru:pi:@	
crow	kr@U	
crowbar	'kr@Uba:	
crowd	kra:Ud	
crown	kra:Un	
crucial	'kru:S@l	
crucify	'kru:s@fa:I	
crude	kru:d	
cruel	'kru:@l	
cruise	kru:z	
crumb	kram	
crumble	'kramb@l	
crummy	'krami:	
crumpet	'kramp@t	
crumple	'kramp@l	
crunch	krantS	
crusade	kru:'sEId	
crush	kraS	
crust	krast	
crustacean	kras'tEIS@n	
crutch	kratS	
crux	kraks	
cry	kra:I	
cryptic	'krIptIk	
crystal	'krIst@l	
cub	kab	
cube	kju:b	
cubic	'kju:bIk	
cubicle	'kju:bIk@l	
cucumber	'kju:kamb@	
cuddle	'kad@l	
cuddly	'kadli:	
cue	kju:	
cuff	kaf	
cul-de-sac	'kal-d@-sAk	
culinary	'kal@nri:	
culminate	'kalm@nEIt	
culprit	'kalpr@t	
cult	kalt	
cultivate	'kalt@vEIt	
culture	'kaltS@	
cumbersome	'kamb@s@m	
cumquat	'kamkwOt	
cunning	'kanIN	
cunt	kant	
cup	kap	
cupboard	'kab@d	
curb	k@:b	
curdle	'k@:d@l	
cure	'kju:@	
curious	'kju:ri:@s	
curl	k@:l	
currant	'kar@nt	
currawong	'kar@wON	
currency	'kar@nsi:	
current	'kar@nt	
curriculum	k@'rIkj@l@m	
curriculumvitae	k@rIkj@l@m'vi:ta:I	
curry	'kari:	
curse	k@:s	
curt	k@:t	
curtail	k@:'tEIl	
curtain	'k@:t@n	
curtsy	'k@:tsi:	
curve	k@:v	
cushion	'kUS@n	
cushy	'kUSi:	
custard	'kast@d	
custody	'kast@di:	
custom	'kast@m	
customary	'kast@m@ri:	'kast@mri:
customer	'kast@m@	
cut	kat	
cute	kju:t	
cuticle	'kju:tIk@l	
cutlery	'katl@ri:	
cutlet	'katl@t	
cv	si:'vi:	
cycle	'sa:Ik@l	
cyclone	'sa:Ikl@Un	
cylinder	'sIl@nd@	
cynic	'sInIk	
cynical	'sInIk@l	
cyst	sIst	
cystitis	sIs'ta:It@s	
czech	tSEk	
d	di:	
dab	dAb	
dad	dAd	
dagger	dAɡ@	
daily	'dEIli:	
dainty	'dEInti:	
dairy	dE@ri:	
dais	'dEI@s	
dam	dAm	
damage	'dAmIdZ	
damn	dAm	
damned	dAmd	
damnedest	'dAmd@st	
damp	dAmp	
dampen	'dAmp@n	
damper	'dAmp@	
dance	dAns	
dandruff	'dAndraf	
danger	'dEIndZ@	
dangle	dANɡ@l	
dank	dANk	
dapper	'dAp@	
dappled	'dAp@ld	
dare	dE@	
daredevil	'dE@dEv@l	
dark	da:k	
darkroom	'da:kru:m	
darling	'da:lIN	
darn	da:n	
dart	da:t	
dash	dAS	
dashboard	'dASbo:d	
data	'da:t@	
database	'dEIt@bEIs	
date	dEIt	
dated	'dEIt@d	
daub	do:b	
daughter	'do:t@	
daughter-in-law	'do:t@r-In-lo:	
daunt	do:nt	
dawdle	'do:d@l	
dawn	do:n	
day	dEI	
daycarecentre	'dEIkE@sEnt@	
daybreak	'dEIbrEIk	
daydream	'dEIdri:m	
daylight	'dEIla:It	
daytime	'dEIta:Im	
daze	dEIz	
dazzle	'dAz@l	
defacto	d@'fAkt@U	
dead	dEd	
deadend	dEd'End	
deadheat	dEd'hi:t	
deadletter	dEd'lEt@	
dead-end	dEd-'End	
deaden	'dEd@n	
deadline	'dEdla:In	
deadlock	'dEdlOk	
deadly	'dEdli:	
deaf	dEf	
deal	di:l	
dealer	'di:l@	
dealings	'di:lINz	
dear	dI@	
death	dET	
debatable	d@'bEIt@b@l	
debate	d@'bEIt	
debit	'dEb@t	
debris	'dEbri:	
debt	dEt	
debug	di:'baɡ	
debut	'dEIbju:	
decade	'dEkEId	
decadent	'dEk@d@nt	
decaffeinated	di:'kAf@nEIt@d	
decapitate	di:'kAp@tEIt	
decathlon	d@'kATlOn	
decay	di:'kEI	d@'kEI
deceased	d@'si:st	
deceitful	d@'si:tfUl	
deceive	d@'si:v	
december	d@'sEmb@	
decent	'di:s@nt	
decentralise	di:'sEntr@la:Iz	
deception	d@'sEpS@n	
deceptive	d@'sEptIv	
decibel	'dEs@bEl	
decide	d@'sa:Id	
decided	d@'sa:Id@d	
deciduous	d@'sIdZu:@s	
decimal	'dEs@m@l	
decimate	'dEs@mEIt	
decipher	d@'sa:If@	
decision	d@'sIZ@n	
deck	dEk	
declare	d@'klE@	
decline	d@'kla:In	
decode	di:'k@Ud	
decompose	di:k@m'p@Uz	
decongestant	di:k@n'dZEst@nt	
decor	'dEIko:	
decorate	'dEk@rEIt	
decoration	dEk@'rEIS@n	
decorum	d@'ko:r@m	
decoy	'di:ko:I	
decrease	d@'kri:s	'di:kri:s
decree	d@'kri:	
decrepit	d@'krEp@t	
decry	d@'kra:I	
dedicate	'dEd@kEIt	
deduce	d@'dju:s	
deduct	d@'dakt	
deduction	d@'dakS@n	
deed	di:d	
deep	di:p	
deepfreeze	di:p'fri:z	
deer	dI@	
deface	d@'fEIs	
defamation	dEf@'mEIS@n	
default	d@'fOlt	
defeat	d@'fi:t	
defecate	'dEf@kEIt	
defect	'di:fEkt	
defence	d@'fEns	
defend	d@'fEnd	
defendant	d@'fEnd@nt	
defensive	d@'fEnsIv	
defer	d@'f@:	
defiant	d@'fa:I@nt	
deficient	d@'fIS@nt	
deficit	'dEf@s@t	
define	d@'fa:In	
definite	'dEf@n@t	
definitive	d@'fIn@tIv	
deflate	d@'flEIt	
deflation	d@'flEIS@n	
deflect	d@'flEkt	
defoliant	d@'f@Uli:@nt	
defoliate	d@'f@Uli:EIt	
deform	d@'fo:m	
defraud	d@'fro:d	
defrost	di:'frOst	
deft	dEft	
defunct	d@'faNkt	
defuse	di:'fju:z	d@'fju:z
defy	d@'fa:I	
degenerate	d@'dZEn@r@t	
degradation	dEɡr@'dEIS@n	
degrade	d@'ɡrEId	
degree	d@'ɡri:	
dehydrate	'di:ha:IdrEIt	
deign	dEIn	
deity	'dEI@ti:	
dejected	d@'dZEkt@d	
delay	d@'lEI	
delectable	d@'lEkt@b@l	
delegate	dEl@ɡ@t	
delegation	dEl@'ɡEIS@n	
delete	d@'li:t	
deli	dEli:	
deliberate	d@'lIb@r@t	d@'lIbr@t
delicacy	'dEl@k@si:	
delicate	'dEl@k@t	
delicatessen	dEl@k@'tEs@n	
delicious	d@'lIS@s	
delight	d@'la:It	
delinquent	d@'lINkw@nt	
delirious	d@'lI@ri:@s	
deliver	d@'lIv@	
delta	'dElt@	
delude	d@'lu:d	
deluge	'dElju:dZ	
deluxe	d@'laks	
delve	dElv	
demand	d@'mAnd	
demanding	d@'mAndIN	
demean	d@'mi:n	
demeanour	d@'mi:n@	
demented	d@'mEnt@d	
dementia	d@'mEnS@	
demerit	di:'mEr@t	
demise	d@'ma:Iz	
demister	di:'mIst@	
demo	'dEm@U	
democracy	d@'mOkr@si:	
democrat	'dEm@krAt	
democrats	'dEm@krAts	
demolish	d@'mOlIS	
demon	'di:m@n	
demonstrate	'dEm@nstrEIt	
demonstration	dEm@n'strEIS@n	
demonstrative	d@'mOnstr@tIv	
demoralise	d@'mOr@la:Iz	
demote	di:'m@Ut	
demure	d@'mjU@	
den	dEn	
denigrate	dEn@ɡrEIt	
denim	'dEn@m	
denomination	d@nOm@'nEIS@n	
denominator	d@'nOm@nEIt@	
denounce	d@'na:Uns	
dense	dEns	
dent	dEnt	
dental	'dEnt@l	
dentalfloss	'dEnt@lflOs	
dentist	'dEnt@st	
denture	'dEntS@	
deny	d@'na:I	
deodorant	di:'@Ud@r@nt	
depart	d@'pa:t	
departed	d@'pa:t@d	
department	d@'pa:tm@nt	
depend	d@'pEnd	
dependant	d@'pEnd@nt	
dependent	d@'pEnd@nt	
depict	d@'pIkt	
deplete	d@'pli:t	
deplore	d@'plo:	
deport	d@'po:t	
deportment	d@'po:tm@nt	
depose	d@'p@Uz	
deposit	d@'pOz@t	
depository	d@'pOz@tri:	
depot	'dEp@U	
depraved	d@'prEIvd	
depreciate	d@'pri:Si:EIt	
depress	d@'prEs	
depression	d@'prES@n	
deprive	d@'pra:Iv	
deprived	d@'pra:Ivd	
dept	d@'pa:tm@nt	
depth	dEpT	
deputation	dEpju:'tEIS@n	dEpj@'tEIS@n
deputy	'dEpj@ti:	
deranged	d@'rEIndZd	
derelict	'dEr@lIkt	
deride	d@'ra:Id	
derivative	d@'rIv@tIv	
derive	d@'ra:Iv	
dermatitis	d@:m@'ta:It@s	
derogatory	d@'rOɡ@tri:	
descend	d@'sEnd	
descendant	d@'sEnd@nt	
descended	d@'sEnd@d	
descent	d@'sEnt	
describe	d@'skra:Ib	
description	d@'skrIpS@n	
desecrate	'dEs@krEIt	
desert	'dEz@t	
deserve	d@'z@:v	
design	d@'za:In	
designate	dEzIɡnEIt	
desirable	d@'za:Ir@b@l	
desire	d@'za:I@	
desk	dEsk	
desktop	'dEsktOp	
desolate	'dEs@l@t	
despair	d@'spE@	
desperate	'dEspr@t	
despicable	d@'spIk@b@l	
despise	d@'spa:Iz	
despite	d@'spa:It	
despondent	d@'spOnd@nt	
despot	'dEspOt	
dessert	d@'z@:t	
destination	dEst@'nEIS@n	
destined	'dEst@nd	
destiny	'dEst@ni:	
destitute	'dEst@tju:t	
destroy	d@'stro:I	
detach	d@'tAtS	
detached	d@'tAtSt	
detachment	d@'tAtSm@nt	
detail	'di:tEIl	
detain	d@'tEIn	
detect	d@'tEkt	
detective	d@'tEktIv	
detention	d@'tEnS@n	
deter	d@'t@:	
detergent	d@'t@:dZ@nt	
deteriorate	d@'tI@ri:@rEIt	
determination	d@t@:m@'nEIS@n	
determine	d@'t@:m@n	
determined	d@'t@:m@nd	
determiner	d@'t@:m@n@	
deterrent	d@'tEr@nt	
detest	d@'tEst	
detonate	'dEt@nEIt	
detour	'di:tU@	
detract	d@'trAkt	
detrimental	dEtr@'mEnt@l	
devalue	di:'vAlju:	
devastate	'dEv@stEIt	
devastating	'dEv@stEItIN	
develop	d@'vEl@p	
developer	d@'vEl@p@	
development	d@'vEl@pm@nt	
deviant	'di:vi:@nt	
deviate	'di:vi:EIt	
device	d@'va:Is	
devil	'dEv@l	
devious	'di:vi:@s	
devise	d@'va:Iz	
devoid	d@'vo:Id	
devote	d@'v@Ut	
devoted	d@'v@Ut@d	
devotee	dEv@'ti:	
devour	d@'va:U@	
devout	d@'va:Ut	
dew	dju:	dZu:
dexterity	dEks'tEr@ti:	
diabetes	da:I@'bi:ti:z	
diabolic	da:I@'bOlIk	
diagnose	da:I@ɡn@Uz	
diagonal	da:I'Aɡ@n@l	
diagram	da:I@ɡrAm	
dial	'da:I@l	
dialect	'da:I@lEkt	
dialogue	da:I@lOɡ	
diameter	da:I'Am@t@	
diametrically	da:I@'mEtrIkli:	
diamond	'da:I@m@nd	
diaphragm	'da:I@frAm	
diarrhoea	da:I@'ri:@	
diary	'da:I@ri:	
dice	da:Is	
dicey	'da:Isi:	
dick	dIk	
dickhead	'dIkhEd	
dictate	dIk'tEIt	
dictator	dIk'tEIt@	
diction	'dIkS@n	
dictionary	'dIkS@nri:	
did	dId	
didgeridoo	dIdZ@ri:'du:	
die	da:I	
diesel	'di:z@l	
diet	'da:I@t	
differ	'dIf@	
difference	'dIfr@ns	
different	'dIfr@nt	
differentiate	dIf@'rEnSi:EIt	
difficult	'dIf@k@lt	
diffident	'dIf@d@nt	
diffuse	d@'fju:z	
dig	dIɡ	
digest	d@'dZEst	da:I'dZEst
digger	dIɡ@	
diggings	dIɡINz	
digit	'dIdZ@t	
digital	'dIdZ@t@l	
dignitary	dIɡn@tri:	
dignity	dIɡn@ti:	
digress	da:I'ɡrEs	
dilapidated	d@'lAp@dEIt@d	
dilate	da:I'lEIt	
dilemma	d@'lEm@	
diligent	'dIl@dZ@nt	
dill	dIl	
dilute	da:I'lu:t	
dim	dIm	
dimension	d@'mEnS@n	
diminish	d@'mInIS	
dimple	'dImp@l	
din	dIn	
dine	da:In	
diner	'da:In@	
ding	dIN	
dinghy	dINɡi:	
dingo	dINɡ@U	
dingy	'dIndZi:	
dining	'da:InIN	
diningcar	'da:InINka:	
diningroom	'da:InINru:m	
diningtable	'da:InINtEIb@l	
dinki-di	dINki:-'da:I	
dinkum	'dINk@m	
dinner	'dIn@	
dinosaur	'da:In@so:	
dip	dIp	
diphtheria	dIf'TI@ri:@	
diphthong	'dIfTON	
diploma	d@'pl@Um@	
diplomacy	d@'pl@Um@si:	
diplomat	'dIpl@mAt	
dire	da:I@	
direct	d@'rEkt	
direction	d@'rEkS@n	
directive	d@'rEktIv	
directly	d@'rEktli:	
director	d@'rEkt@	
directory	d@'rEktri:	
dirt	d@:t	
dirty	'd@:ti:	
disability	dIs@'bIl@ti:	
disable	dIs'EIb@l	
disadvantage	dIs@d'vAntIdZ	
disadvantaged	dIs@d'vAntIdZd	
disagree	dIs@'ɡri:	
disagreeable	dIs@'ɡri:@b@l	
disallow	dIs@'la:U	
disappear	dIs@'pI@	
disappoint	dIs@'po:Int	
disapprove	dIs@'pru:v	
disarm	dIs'a:m	
disarray	dIs@'rEI	
disaster	d@'za:st@	
disband	dIs'bAnd	
disbelieve	dIsb@'li:v	
disc	dIsk	
discjockey	'dIskdZOki:	
discard	dIs'ka:d	
discern	dI's@:n	d@'s@:n
discerning	dI's@:nIN	d@'s@:nIN
discharge	dIs'tSa:dZ	
disciple	d@'sa:Ip@l	
disciplinarian	dIs@pl@'nE@ri:@n	
discipline	'dIs@pl@n	
disclose	dIs'kl@Uz	d@s'kl@Uz
disco	'dIsk@U	
discolour	dIs'kal@	
discomfort	dIs'kamf@t	
disconcert	dIsk@n's@:t	
disconnect	dIsk@'nEkt	
discontent	dIsk@n'tEnt	
discontinue	dIsk@n'tInju:	
discord	'dIsko:d	
discount	'dIska:Unt	
discourage	dIs'karIdZ	
discourse	'dIsko:s	
discourteous	dIs'k@:ti:@s	
discover	dI'skav@	d@'skav@
discredit	dI'skrEd@t	dIs'krEd@t
discreet	dI'skri:t	d@'skri:t
discrepancy	dI'skrEp@nsi:	d@'skrEp@nsi:
discrete	dI'skri:t	d@'skri:t
discretion	dI'skrES@n	d@'skrES@n
discriminate	dI'skrIm@nEIt	d@'skrIm@nEIt
discuss	d@s'kas	d@'skas
disdain	dIs'dEIn	
disease	d@'zi:z	
disfavour	dIs'fEIv@	
disfigure	dIs'fIɡ@	
disgrace	d@s'ɡrEIs	
disgruntled	dIs'ɡrant@ld	
disguise	dIs'ɡa:Iz	d@s'ɡa:Iz
disgust	d@s'ɡast	
dish	dIS	
disheartened	dIs'ha:t@nd	
dishevelled	dI'SEv@ld	
dishonest	dIs'On@st	
dishonour	dIs'On@	
dishwasher	'dISwOS@	
disillusioned	dIs@'lu:Z@nd	
disinclined	dIsIn'kla:Ind	dIsIN'kla:Ind
disinfect	dIsIn'fEkt	
disinfectant	dIsIn'fEkt@nt	
disintegrate	dIs'Int@ɡrEIt	
disinterested	dIs'Intr@st@d	
disjointed	dIs'dZo:Int@d	
disk	dIsk	
diskette	dIs'kEt	
dislike	dIs'la:Ik	
dislocate	'dIsl@kEIt	
dislodge	dIs'lOdZ	
disloyal	dIs'lo:I@l	
dismal	'dIzm@l	
dismantle	dIs'mAnt@l	
dismay	dIs'mEI	
dismiss	dIs'mIs	
dismount	dIs'ma:Unt	
disobey	dIs@'bEI	
disorder	dIs'o:d@	
disorganised	dIs'o:ɡ@na:Izd	
disorientated	dIs'Ori:@n;tEIt@d	
dispatch	dIs'pAtS	
dispel	dI'spEl	
dispensable	dI'spEns@b@l	
dispensation	dIspEn'sEIS@n	
dispense	dI'spEns	
disperse	dI'sp@:s	
displace	dI'splEIs	
display	dI'splEI	
displease	dIs'pli:z	
disposable	dI'sp@Uz@b@l	
disposableincome	dI;sp@Uz@b@l'INkam	
disposal	dI'sp@Uz@l	
dispose	dI'sp@Uz	
disposed	dI'sp@Uzd	
disposition	dIsp@'zIS@n	
dispossess	dIsp@'zEs	
disproportion	dIspr@'po:S@n	
disprove	dIs'pru:v	
dispute	dI'spju:t	
disqualify	dI'skwOl@fa:I	
disregard	dIsr@'ɡa:d	
disrepair	dIsr@'pE@	
disreputable	dIs'rEpj@t@b@l	
disrepute	dIsr@'pju:t	
disrespect	dIsr@'spEkt	
disrupt	dIs'rapt	
dissatisfied	dI'sAtIsfa:Id	
dissect	da:I'sEkt	d@'sEkt
dissension	dI'sEnS@n	d@'sEnS@n
dissent	dI'sEnt	d@'sEnt
dissertation	dIs@'tEIS@n	
dissident	'dIs@d@nt	
dissimilar	dIs'sIm@l@	
dissipate	'dIs@pEIt	
dissociate	dIs's@Usi:EIt	
dissolution	dIs@'lu:S@n	
dissolve	d@'zOlv	
dissuade	dIs'swEId	
distance	'dIst@ns	
distant	'dIst@nt	
distasteful	dI'stEIstfUl	dIs'tEIstf@l
distend	dI'stEnd	
distil	dI'stIl	
distillate	'dIst@l@t	
distinct	d@'stINkt	
distinction	d@'stINkS@n	
distinctive	d@'stINktIv	
distinguish	d@'stINɡwIS	
distort	d@'sto:t	
distract	d@'strAkt	
distraught	dI'stro:t	d@'stro:t
distress	d@'strEs	
distribute	d@'strIbju:t	
distribution	dIstr@'bju:S@n	
district	'dIstrIkt	
distrust	dIs'trast	
disturb	d@'st@:b	
disturbance	d@'st@:b@ns	
disturbed	d@'st@:bd	
disuse	dIs'ju:s	
ditch	dItS	
dither	'dID@	
ditto	'dIt@U	
divan	d@'vAn	
dive	da:Iv	
diver	'da:Iv@	
diverge	da:I'v@:dZ	
diverse	da:I'v@:s	
diversify	d@'v@:s@fa:I	
diversion	d@'v@:Z@n	
divide	d@'va:Id	
dividend	'dIv@dEnd	
divination	dIv@'nEIS@n	
divine	d@'va:In	
divinity	d@'vIn@ti:	
division	d@'vIZ@n	
divorce	d@'vo:s	
divorcee	d@vo:'si:	
divulge	d@'valdZ	
dizzy	'dIzi:	
do	du:	
dob	dOb	
docile	'd@Usa:Il	
dock	dOk	
docket	'dOk@t	
dockyard	'dOkja:d	
doctor	'dOkt@	
doctors	dOkt@z	
doctrine	'dOktr@n	
document	'dOkj@m@nt	
documentary	dOkj@'mEntri:	
dodge	dOdZ	
dodgy	'dOdZi:	
doe	d@U	
does	daz	
dog	dOɡ	
dog-ear	dOɡ-I@	
dogged	dOɡ@d	
dogleg	dOɡlEɡ	
dogma	dOɡm@	
dogmatic	dOɡ'mAtIk	
doily	'do:Ili:	
doing	'du:IN	
doldrums	'dOldr@mz	
dole	d@Ul	
doleful	'd@UlfUl	
doll	dOl	
dollar	'dOl@	
dollop	'dOl@p	
doll’s	dOlz	
domain	d@'mEIn	
dome	d@Um	
domestic	d@'mEstIk	
domesticate	d@'mEst@kEIt	
dominate	'dOm@nEIt	
domineering	dOm@'nI@rIN	
donate	d@U'nEIt	
done	dan	
donkey	'dONki:	
donor	'd@Un@	
dont	d@Unt	
doodle	'du:d@l	
doom	du:m	
doomsday	'du:mzdEI	
doona	'du:n@	
door	do:	
dope	d@Up	
dopey	'd@Upi:	
dork	do:k	
dorm	do:m	
dormant	'do:m@nt	
dormitory	'do:m@tri:	
dose	d@Us	
dossier	'dOsi:@	
dot	dOt	
dote	d@Ut	
dotty	'dOti:	
double	'dab@l	
doublebass	dab@l'bEIs	
doublecross	dab@l'krOs	
doubt	da:Ut	
doubtful	'da:UtfUl	
dough	d@U	
dour	dU@	
douse	da:Us	
dove	dav	
dowdy	'da:Udi:	
down	da:Un	
downpayment	da:Un'pEIm@nt	
down-market	da:Un-'ma:k@t	
down-to-earth	da:Un-tu:-'@:T	
downcast	'da:Unka:st	
downfall	'da:Unfo:l	
downgrade	da:Un'ɡrEId	
downhearted	da:Un'ha:t@d	
downhill	da:Un'hIl	
downplay	da:Un'plEI	
downpour	'da:Unpo:	
downstream	da:Un'stri:m	
downtown	da:Unta:Un	
downtrodden	da:Un'trOd@n	
downturn	'da:Unt@:n	
downward	'da:Unw@d	
downwards	'da:Unw@dz	
downwind	da:Un'wInd	
downy	'da:Uni:	
dowry	'da:Uri:	
doz	'daz@n	
doze	d@Uz	
dozen	'daz@n	
dr	'dOkt@	
drab	drAb	
draft	dra:ft	
drag	drAɡ	
dragon	drAɡ@n	
dragonfly	drAɡ@nfla:I	
drain	drEIn	
drake	drEIk	
drama	'dra:m@	
dramatic	dr@'mAtIk	
dramatise	'drAm@ta:Iz	
drank	drANk	
drape	drEIp	
drastic	'drAstIk	
draught	dra:ft	
draw	dro:	
drawback	'dro:bAk	
drawcard	'dro:ka:d	
drawer	dro:	
drawing-pin	'dro:IN-pIn	
drawl	dro:l	
drawn	dro:n	
dread	drEd	
dreadful	'drEdfUl	
dream	dri:m	
dreaming	'dri:mIN	
dreamt	drEmt	
dreary	'drI@ri:	
drench	drEntS	
dress	drEs	
dresser	'drEs@	
dressing	'drEsIN	
dressing-gown	drEsIN-ɡa:Un	
dressing-table	'drEsIN-tEIb@l	
dressmaker	'drEsmEIk@	
drew	dru:	
dribble	'drIb@l	
dried	dra:Id	
drier	'dra:I@	
drift	drIft	
drill	drIl	
drink	drINk	
drink-driving	drINk-'dra:IvIN	
drip	drIp	
drip-dry	'drIp-dra:I	
dripping	'drIpIN	
drive	dra:Iv	
drive-in	'dra:Iv-In	
driverslicence	'dra:Iv@zla:Is@ns	
driveway	'dra:IvwEI	
drivingtest	'dra:IvINtEst	
drizzle	'drIz@l	
drone	dr@Un	
drongo	drONɡ@U	
droop	dru:p	
drop	drOp	
drop-out	'drOp-a:Ut	
droplet	'drOpl@t	
dropper	'drOp@	
droppings	'drOpINz	
drought	dra:Ut	
drove	dr@Uv	
drown	dra:Un	
drowsy	'dra:Uzi:	
drug	draɡ	
drum	dram	
drumstick	'dramstIk	
drunk	draNk	
dry	dra:I	
dry-clean	dra:I-'kli:n	
dual	'dju:@l	
dub	dab	
dubious	'dju:bi:@s	
duck	dak	
due	dju:	dZu:
duel	'dju:@l	
duet	dju:'Et	
dug	daɡ	
dugout	daɡa:Ut	
dull	dal	
duly	'dju:li:	
dumb	dam	
dummy	'dami:	
dump	damp	
dumpling	'damplIN	
dumpy	'dampi:	
dune	dju:n	dZu:n
dung	daN	
dunk	daNk	
dunny	'dani:	
duo	'dju:@U	
duodenum	dju:@'di:n@m	
dupe	dju:p	
duplex	'dju:plEks	
duplicate	'dju:pl@kEIt	
durable	'dju:r@b@l	
duration	dju:'rEIS@n	
during	'dju:rIN	
dusk	dask	
dust	dast	
dustpan	'dastpAn	
dutch	datS	
duty	'dju:ti:	
duty-free	dju:ti:-'fri:	
duvet	'du:vEI	
dwarf	dwo:f	
dwell	dwEl	
dwindle	'dwInd@l	
dye	da:I	
dying	'da:IIN	
dynamic	da:I'nAmIk	
dynamics	da:I'nAmIks	
dynamite	'da:In@ma:It	
dysentery	'dIs@ntri:	
dyslexia	dIs'lEksi:@	
e	i:	
e-mail	'i:-mEIl	
eg	i:'dZi:	
each	i:tS	
eager	i:ɡ@	
ear	I@	
eardrum	'I@dram	
early	'@:li:	
earn	@:n	
earnest	'@:n@st	
earphone	'I@f@Un	
earring	'I@rIN	
earth	@:T	
earthenware	'@:D@nwE@	
earthquake	'@:TkwEIk	
ease	i:z	
easel	'i:z@l	
east	i:st	
easter	'i:st@	
eastward	'i:stw@d	
easy	'i:zi:	
eat	i:t	
eaves	i:vz	
eavesdrop	'i:vzdrOp	
eb	i:'bi:	
ebb	Eb	
eccentric	@k'sEntrIk	Ek'sEntrIk
ecg	i:si:'dZi:	
echidna	@'kIdn@	
echo	'Ek@U	
eclipse	@'klIps	
ecology	@'kOl@dZi:	
economics	Ek@'nOmIks	
economy	@'kOn@mi:	
eczema	'Eks@m@	
edge	EdZ	
edible	'Ed@b@l	
edit	'Ed@t	
edition	@'dIS@n	
editorial	Ed@'to:ri:@l	
education	EdZ@'kEIS@n	
eerie	'I@ri:	
effect	@'fEkt	
effective	@'fEktIv	
effeminate	@'fEm@n@t	
effervescent	Ef@'vEs@nt	
efficient	@'fIS@nt	
effort	'Ef@t	
eftpos	'EftpOs	
egg	Eɡ	
ego	i:ɡ@U	
eiderdown	'a:Id@da:Un	
eight	EIt	
eighteen	EI'ti:n	
eighteenth	EI'ti:nT	
eighth	EItT	
eighty	'EIti:	
either	'a:ID@	
eject	@'dZEkt	
elaborate	@'lAb@r@t	
elapse	@'lAps	
elastic	@'lAstIk	
elated	@'lEIt@d	
elbow	'Elb@U	
elder	'Eld@	
elderly	'Eld@li:	
eldest	'Eld@st	
elect	@'lEkt	
election	@'lEkS@n	
elective	@'lEktIv	
electorate	@'lEkt@r@t	
electrician	@lEk'trIS@n	
electricity	@lEk'trIs@ti:	
electrocute	@'lEktr@kju:t	
electronic	El@k'trOnIk	
elegant	El@ɡ@nt	
element	'El@m@nt	
elementary	El@'mEntri:	
elevate	'El@vEIt	
elevator	'El@vEIt@	
eleven	@'lEv@n	
eleventh	@'lEv@nT	
eligible	'El@dZ@b@l	
eliminate	@'lIm@nEIt	
elite	@'li:t	
ellipse	@'lIps	
eloquent	'El@kw@nt	
else	Els	
elsewhere	'ElswE@	
elusive	@'lu:sIv	
embargo	@m'ba:ɡ@U	
embark	@m'ba:k	
embarrass	@m'bAr@s	
embassy	'Emb@si:	
embezzle	@m'bEz@l	
emblem	'Embl@m	
embrace	@m'brEIs	
embroider	@m'bro:Ud@	Em'bro:Id@
embryo	'Embri:@U	
emerald	'Emr@ld	
emerge	@'m@:dZ	
emergency	@'m@:dZ@nsi:	
emigrant	Em@ɡr@nt	
emigrate	Em@ɡrEIt	
eminent	'Em@n@nt	
emotion	@'m@US@n	
emphasis	'Emf@s@s	
empire	'Empa:I@	
employ	@m'plo:I	
empty	'Emti:	
emu	'i:mju:	
enable	@n'EIb@l	
enamel	@'nAm@l	
enclose	@n'kl@Uz	
encode	@n'k@Ud	
encore	'Onko:	
encounter	@n'ka:Unt@	
encourage	@n'karIdZ	
encyclopedia	Ensa:Ikl@'pi:di:@	
end	End	
endanger	@n'dEIndZ@	
endeavour	@n'dEv@	
endorse	@n'do:s	
endure	@n'dju:@	
enemy	'En@mi:	
energy	'En@dZi:	
engage	@n'ɡEIdZ	
engagement	@n'ɡEIdZm@nt	
engine	'EndZ@n	
engineer	EndZ@'nI@	
english	INɡlIS	
engrave	@n'ɡrEIv	
enjoy	@n'dZo:I	
enlarge	@n'la:dZ	
enlist	@n'lIst	
enormous	@'no:m@s	
enough	@'naf	
enquiry	In'kwa:Iri:	
enrage	@n'rEIdZ	
enrich	@n'rItS	
enrol	@n'r@Ul	
ensuite	'Onswi:t	
ensure	@n'So:	
entangled	@n'tANɡ@ld	
enter	'Ent@	
enterprise	'Ent@pra:Iz	
enterprisebargaining	Ent@pra:Iz'ba:ɡ@nIN	
entertain	Ent@'tEIn	
enthusiasm	@n'Tu:zi:Az@m	
entice	@n'ta:Is	
entire	@n'ta:I@	
entitle	@n'ta:It@l	
entrance	'Entr@ns	
entrant	'Entr@nt	
entreat	@n'tri:t	
entree	'OntrEI	
entrepreneur	Ontr@pr@'n@:	
entry	'Entri:	
envelope	'Env@l@Up	
environment	En'va:Ir@nm@nt	
envy	'Envi:	
epic	'EpIk	
epidemic	Ep@'dEmIk	
epilepsy	'Ep@lEpsi:	
episode	'Ep@s@Ud	
epitome	@'pIt@mi:	
epoch	'i:pOk	
equal	'i:kw@l	
equator	@'kwEIt@	
equip	@'kwIp	
equipment	@'kwIpm@nt	
equivalent	@'kwIv@l@nt	
era	'I@r@	
eradicate	@'rAd@kEIt	
erase	@'rEIz	
erect	@'rEkt	
erode	@'r@Ud	
erotic	@'rOtIk	
err	@:	
errand	'Er@nd	
erratic	@'rAtIk	
error	'Er@	
erupt	@'rapt	
escalate	'Esk@lEIt	
escalator	'Esk@lEIt@	
escapade	'Esk@pEId	
escape	@s'kEIp	
escort	@s'ko:t	
esky	'Eski:	
esl	i:Es'El	
especially	@s'pES@li:	
espionage	'Espi:@na:Z	
essay	'EsEI	
essence	'Es@ns	
essential	@'sEnS@l	
establish	@s'tAblIS	
establishment	@stAblISm@nt	
estate	@stEIt	
estateagent	@'stEItEIdZ@nt	
esteem	@s'ti:m	
estimate	'Est@mEIt	'Est@m@t
estranged	@'strEIndZd	
etc	Et'sEtr@	
etch	EtS	
etching	'EtSIN	
eternal	@'t@:n@l	
ethics	'ETIks	
ethnic	'ETnIk	
etiquette	'EtIk@t	
eucalyptus	ju:k@'lIpt@s	
euthanasia	ju:T@'nEIZ@	
evacuate	@'vAkju:EIt	
evade	@'vEId	
evaluate	@'vAlju:EIt	
evaporate	@'vAp@rEIt	
eve	i:v	
even	'i:v@n	
evening	'i:vnIN	
eveningclass	'i:vnINkla:s	
eveningdress	'i:vnINdrEs	
event	@'vEnt	
eventually	@'vEntS@li:	
ever	'Ev@	
evergreen	Ev@ɡri:n	
every	'Evri:	
everybody	'Evri:bOdi:	
everyday	'Evri:dEI	
everyone	'Evri:wan	
everything	'Evri:TIN	
everywhere	'Evri:wE@	
evict	@'vIkt	
evidence	'Ev@d@ns	
evident	'Ev@d@nt	
evil	'i:v@l	
evolution	Ev@'lu:S@n	
ex-	Eks-	
exact	@ɡ'zAkt	
exactly	@ɡ'zAktli:	
exaggerate	@ɡ'zAdZ@rEIt	
exam	@ɡ'zAm	
examination	@ɡzAm@'nEIS@n	
examine	@ɡ'zAm@n	
example	@ɡ'zAmp@l	
exasperate	@ɡ'zAsp@rEIt	
excavate	'Eksk@vEIt	
exceed	@k'si:d	
excel	@k'sEl	
excellent	'Eks@l@nt	
except	@k'sEpt	
exception	@k'sEpS@n	
exceptional	@k'sEpS@n@l	
excess	'EksEs	
exchange	@ks'tSEIndZ	
excite	@k'sa:It	
excited	@k'sa:It@d	
exciting	@k'sa:ItIN	
exclaim	@ks'klEIm	
exclamation	Ekskl@'mEIS@n	
exclude	@ks'klu:d	
exclusive	@ks'klu:sIv	
excrete	@ks'kri:t	
excruciating	@ks'kru:Si:EItIN	
excursion	@k'sk@:S@n	
excuse	@k'skju:s	
execute	'Eks@kju:t	
executive	@ɡ'zEkj@tIv	
executor	@ɡ'zEkj@t@	
exempt	@ɡ'zEmpt	
exercise	'Eks@sa:Iz	
exert	@ɡ'z@:t	
exhale	Eks'hEIl	
exhaust	@ɡ'zo:st	
exhaustive	@ɡ'zo:stIv	
exhibit	@ɡ'zIb@t	
exile	Eɡza:Il	
exist	@ɡ'zIst	
exit	'Eɡz@t	'Eks@t
exodus	'Eks@d@s	
exotic	@ɡ'zOtIk	
expand	@k'spAnd	
expanse	@k'spAns	
expect	@k'spEkt	
expedition	Eksp@'dIS@n	
expel	@k'spEl	
expend	@k'spEnd	
expenditure	Ek'spEnd@tS@	
expense	@k'spEns	
expensive	@k'spEnsIv	
experience	@k'spI@ri:@ns	
experiment	@k'spEr@m@nt	
expert	'Eksp@:t	
expire	@k'spa:I@	
explain	@k'splEIn	
expletive	@k'spli:tIv	
explode	@k'spl@Ud	
exploit	@k'splo:It	
explore	@k'splo:	
explosion	@k'spl@UZ@n	
explosive	Ek'spl@UsIv	
export	@k'spo:t	'Ekspo:t
expose	@k'sp@Uz	
exposure	@k'sp@UZ@	
express	@k'sprEs	
expression	@k'sprES@n	
expressway	Ek'sprEswEI	
expulsion	@k'spalS@n	
exquisite	Ek'skwIz@t	
extend	@k'stEnd	
extension	@k'stEnS@n	
extensive	@k'stEnsIv	
extent	@k'stEnt	
exterior	@k'stI@ri:@	
exterminate	@k'st@:m@nEIt	
external	@k'st@:n@l	
extinct	@k'stINkt	
extinguish	@k'stINɡwIS	
extortion	@k'sto:S@n	
extra	'Ekstr@	
extract	@k'strAkt	
extraordinary	@k'stro:d@nri:	
extravagant	@k'strAv@ɡ@nt	
extreme	@k'stri:m	
extremism	@k'stri:mIz@m	
eye	a:I	
eyebrow	'a:Ibra:U	
eyelash	'a:IlAS	
eyelid	'a:IlId	
eyesight	'a:Isa:It	
eyesore	'a:Iso:	
eyewitness	'a:IwItn@s	
f	Ef	
fable	'fEIb@l	
fabric	'fAbrIk	
fabricate	'fAbr@kEIt	
fabulous	'fAbj@l@s	
facade	f@'sa:d	
face	fEIs	
faceless	'fEIsl@s	
facelift	'fEIslIft	
facet	'fAs@t	
facilitate	f@'sIl@tEIt	
facility	f@'sIl@ti:	
facsimile	fAk'sIm@li:	
fact	fAkt	
faction	'fAkS@n	
factor	'fAkt@	
factory	fAktri:	
factual	'fAktSu:@l	
faculty	'fAk@lti:	
fad	fAd	
fade	fEId	
faeces	'fi:si:z	
fag	fAɡ	
fahrenheit	'fAr@nha:It	
fail	fEIl	
failing	'fEIlIN	
failure	'fEIlj@	
faint	fEInt	
fair	fE@	
fairly	'fE@li:	
fairway	'fE@wEI	
fairy	'fE@ri:	
fairybread	'fE@ri:brEd	
fairyfloss	'fE@ri:flOs	
fairytale	'fE@ri:tEIl	
faith	fEIT	
faithful	'fEITf@l	
fake	fEIk	
fall	fo:l	
fallacy	'fAl@si:	
fallible	'fAl@b@l	
fallout	'fo:la:Ut	
0	fOls	
falter	'fo:lt@	
fame	fEIm	
familiar	f@'mIlj@	
family	'fAm@li:	
familyallowance	fAmli:@'la:U@ns	
familylaw	fAmli:'lo:	
familyplanning	fAmli:'plAnIN	
familyroom	'fAmli:ru:m	
famine	'fAm@n	
famished	'fAmISt	
famous	'fEIm@s	
fan	fAn	
fanatic	f@'nAtIk	
fanbelt	'fAnbElt	
fanciful	'fAns@f@l	
fancy	'fAnsi:	
fang	fAN	
fantastic	fAn'tAstIk	
fantasy	'fAnt@si:	
far	fa:	
far-fetched	fa:-'fEtSt	
far-reaching	fa:-'ri:tSIN	
far-sighted	fa:-'sa:It@d	
farce	fa:s	
fare	fE@	
farewell	fE@'wEl	
farm	fa:m	
fart	fa:t	
farther	'fa:D@	
fascinate	'fAs@nEIt	
fashion	fAS@n	
fast	fa:st	
fastfood	fa:st'fu:d	
fasten	'fa:s@n	
fat	fAt	
fatcat	'fAtkAt	
fatal	'fEIt@l	
fatalistic	fEIt@'lIstIk	
fatality	f@'tAl@ti:	
fate	fEIt	
father	'fa:D@	
father-in-law	'fa:D@r-In-lo:	
fatigue	f@'ti:ɡ	
fatso	'fAts@U	
fault	fOlt	
fauna	'fo:n@	
favour	'fEIv@	
favourable	'fEIv@r@b@l	
favourite	'fEIv@r@t	
fax	fAks	
faze	fEIz	
fear	fI@	
fearful	'fI@f@l	
feasible	'fi:z@b@l	
feast	fi:st	
feat	fi:t	
feather	'fED@	
feature	'fi:tS@	
february	fEbru:Eri:	
fed	fEd	
federal	'fEd@r@l	
federate	'fEd@rEIt	
fee	fi:	
feeble	'fi:b@l	
feed	fi:d	
feedback	'fi:dbAk	
feel	fi:l	
feeler	'fi:l@	
feeling	'fi:lIN	
feet	fi:t	
feign	fEIn	
fell	fEl	
fellow	'fEl@U	
felony	'fEl@ni:	
felt	fElt	
female	'fi:mEIl	
feminine	'fEm@n@n	
feminist	'fEm@n@st	
fence	fEns	
fencing	'fEnsIN	
fend	fEnd	
feral	'fEr@l	
ferment	f@'mEnt	
ferocious	f@'r@US@s	
ferriswheel	'fEr@swi:l	
ferry	'fEri:	
fertile	'f@:ta:Il	
fertilisation	f@:t@la:I'zEIS@n	
fertiliser	'f@:t@la:Iz@	
fervent	'f@:v@nt	
fester	'fEst@	
festival	'fEst@v@l	
festive	'fEstIv	
festoon	fEs'tu:n	
fetch	fEtS	
fete	fEIt	
fetid	'fEt@d	
fetus	'fi:t@s	
feud	fju:d	
fever	'fi:v@	
few	fju:	
fiance	fi:'OnsEI	
fiancee	fi:'OnsEI	
fiasco	fi:'Ask@U	
fib	fIb	
fibre	'fa:Ib@	
fibreglass	fa:Ib@ɡla:s	
fibro	'fa:Ibr@U	
fiction	'fIkS@n	
fiddle	'fId@l	
fiddly	'fIdli:	
fidelity	f@'dEl@ti:	
fidget	'fIdZ@t	
field	fI@ld	
fierce	fI@s	
fiery	'fa:I@ri:	
fifteen	fIf'ti:n	
fifteenth	fIf'ti:nT	
fifth	fIfT	
fifty	'fIfti:	
fight	fa:It	
figment	fIɡm@nt	
figure	fIɡ@	
file	fa:Il	
filial	'fIli:@l	
filing	'fa:IlIN	
filipino	fIl@'pi:n@U	
fill	fIl	
fillet	'fIl@t	
filling	'fIlIN	
film	fIlm	
filter	'fIlt@	
filthy	'fIlTi:	
fin	fIn	
final	'fa:In@l	
finale	f@'na:li:	
finalise	'fa:In@la:Iz	
finalist	'fa:In@l@st	
finally	'fa:In@li:	
finance	'fa:InAns	
financial	f@'nAnS@l	
find	fa:Ind	
fine	fa:In	
finger	fINɡ@	
fingernail	fINɡ@nEIl	
fingerprint	fINɡ@prInt	
finicky	'fInIki:	
finish	fInIS	
finite	'fa:Ina:It	
fire	fa:I@	
firearm	'fa:I@ra:m	
firebreak	'fa:I@brEIk	
firefighter	'fa:I@fa:It@	
fireplace	'fa:I@plEIs	
fireproof	'fa:I@pru:f	
firewood	'fa:I@wUd	
fireworks	'fa:I@w@:ks	
firm	f@:m	
first	f@:st	
first-class	'f@:st-kla:s	
first-hand	'f@:sthAnd	
fish	fIS	
fisherman	'fIS@m@n	
fishy	'fISi:	
fist	fIst	
fit	fIt	
fitness	'fItn@s	
fitting	'fItIN	
five	fa:Iv	
fix	fIks	
fixture	'fIkstS@	
fizz	fIz	
fizzer	'fIz@	
fizzle	'fIz@l	
flab	flAb	
flabbergasted	'flAb@ɡa:st@d	'flAb@ɡAst@d
flaccid	'flAs@d	
flag	flAɡ	
flagon	flAɡ@n	
flagrant	flEIɡr@nt	
flair	flE@	
flak	flAk	
flake	flEIk	
flamboyant	flAm'bo:I@nt	
flame	flEIm	
flaming	'flEImIN	
flammable	'flAm@b@l	
flan	flAn	
flank	flANk	
flannel	'flAn@l	
flannelette	flAn@'lEt	
flap	flAp	
flapjack	'flApdZAk	
flare	flE@	
flash	flAS	
flashflood	flAS'flad	
flashback	'flASbAk	
flashlight	'flASla:It	
flashy	'flASi:	
flask	fla:sk	
flat	flAt	
flatette	flAt'Et	
flatten	'flAt@n	
flatter	'flAt@	
flatulence	'flAtS@l@ns	
flaunt	flo:nt	
flautist	'flo:t@st	
flavour	'flEIv@	
flaw	flo:	
flax	flAks	
flea	fli:	
fleamarket	'fli:ma:k@t	
flea-bitten	'fli:-bIt@n	
fled	flEd	
fledgling	'flEdZlIN	
flee	fli:	
fleece	fli:s	
fleet	fli:t	
fleeting	'fli:tIN	
flesh	flES	
flew	flu:	
flex	flEks	
flexible	'flEks@b@l	
flexitime	'flEksi:ta:Im	
flick	flIk	
flicker	'flIk@	
flight	fla:It	
flimsy	'flImzi:	
flinch	flIntS	
fling	flIN	
flint	flInt	
flip	flIp	
flippant	'flIp@nt	
flipper	'flIp@	
flirt	fl@:t	
flit	flIt	
float	fl@Ut	
flock	flOk	
flog	flOɡ	
flood	flad	
floodlight	'fladla:It	
floor	flo:	
floorboard	'flo:bo:d	
flop	flOp	
floppy	'flOpi:	
flora	'flo:r@	
floral	'flOr@l	
florist	'flOr@st	
floss	flOs	
flour	'fla:U@	
flourish	'flarIS	
flout	fla:Ut	
flow	fl@U	
flower	'fla:U@	
flowerbed	'fla:U@bEd	
flowery	'fla:U@ri:	
flown	fl@Un	
flu	flu:	
fluctuate	'flaktSu:EIt	
flue	flu:	
fluent	'flu:@nt	
fluff	flaf	
fluid	'flu:@d	
fluke	flu:k	
flunk	flaNk	
fluorescent	flU@'rEs@nt	
fluoride	'flU@ra:Id	
flurry	'flari:	
flush	flaS	
fluster	'flast@	
flute	flu:t	
flutter	'flat@	
fly	fla:I	
flyingsaucer	fla:IIN'so:s@	
foal	f@Ul	
foam	f@Um	
fob	fOb	
focus	'f@Uk@s	
fodder	'fOd@	
foetus	'fi:t@s	
fog	fOɡ	
foil	fo:Il	
fold	f@Uld	
folder	'f@Uld@	
foliage	'f@Uli:IdZ	
folk	f@Uk	
folklore	'f@Uklo:	
follow	'fOl@U	
follow-up	'fOl@U-ap	
follower	'fOl@U@	
following	'fOl@UIN	
folly	'fOli:	
fond	fOnd	
food	fu:d	
foodstuff	'fu:dstaf	
fool	fu:l	
foolproof	'fu:lpru:f	
foot	fUt	
football	fUtbo:l	
footing	'fUtIN	
footnote	'fUtn@Ut	
footpath	'fUtpa:T	
footprint	'fUtprInt	
footstep	'fUtstEp	
footwear	'fUtwE@	
for	fo:	
forage	'fOrIdZ	
forbearance	fo:'bE@r@ns	
forbid	f@'bId	
forbidding	f@'bIdIN	
force	fo:s	
forceful	'fo:sfUl	
forceps	'fo:s@ps	
forcible	'fo:s@b@l	
ford	fo:d	
fore	fo:	
forearm	'fo:ra:m	
forebear	'fo:bE@	
forecast	'fo:ka:st	
forefinger	fo:fINɡ@	
foreground	fo:ɡra:Und	
forehead	'fOr@d	
foreign	'fOr@n	
foreman	'fo:m@n	
foremost	'fo:m@Ust	
forensic	f@'rEnsIk	f@'rEnzIk
foresee	fo:'si:	
foreshadow	fo:'SAd@U	
forest	'fOr@st	
forestry	'fOr@stri:	
forever	f@r'Ev@	
foreword	'fo:w@:d	
forfeit	'fo:f@t	
forge	fo:dZ	
forget	f@'ɡEt	
forgive	f@'ɡIv	
fork	fo:k	
forklift	'fo:klIft	
forlorn	f@'lo:n	
form	fo:m	
formal	'fo:m@l	
format	'fo:mAt	
formation	fo:'mEIS@n	
former	'fo:m@	
formidable	'fo:m@d@b@l	fo:'mId@b@l
formula	'fo:mj@l@	
formulate	'fo:mj@lEIt	
forsake	f@'sEIk	
fort	fo:t	
forte	'fo:tEI	
forth	fo:T	
forthcoming	fo:T'kamIN	
forthright	'fo:Tra:It	
fortify	'fo:t@fa:I	
fortnight	'fo:tna:It	
fortress	'fo:tr@s	
fortunate	'fo:tS@n@t	
fortune	'fo:tS@n	
forty	'fo:ti:	
forum	'fo:r@m	
forward	'fo:w@d	
fossick	'fOsIk	
fossil	'fOs@l	
foster	'fOst@	
fought	fo:t	
foul	fa:Ul	
foul-mouthed	'fa:Ul-ma:UDd	
found	fa:Und	
foundation	fa:Un'dEIS@n	
fountain	'fa:Unt@n	
fountainpen	'fa:Unt@npEn	
four	fo:	
four-letterword	fo:-lEt@'w@:d	
four-wheeldrive	fo:-wi:l'dra:Iv	
fourteen	'fo:ti:n	
fourteenth	fo:'ti:nT	
fourth	fo:T	
fox	fOks	
foyer	'fo:I@	
fraction	'frAkS@n	
fracture	'frAktS@	
fragile	'frAdZa:Il	
fragment	frAɡm@nt	
fragrance	frEIɡr@ns	
frail	frEIl	
frame	frEIm	
framework	'frEImw@:k	
franchise	'frAntSa:Iz	
frank	frANk	
frankfurt	'frANkf@t	
frantic	'frAntIk	
fraternal	fr@'t@:n@l	
fraud	fro:d	
fraught	fro:t	
fray	frEI	
frazzled	'frAz@ld	
freak	fri:k	
freckle	'frEk@l	
free	fri:	
free-for-all	'fri:-f@r-o:l	
free-range	'fri:-rEIndZ	
freebie	'fri:bi:	
freedom	'fri:d@m	
freehand	'fri:hAnd	
freehold	'fri:h@Uld	
freelance	'fri:lAns	
freeloader	'fri:l@Ud@	
freestyle	'fri:sta:Il	
freeway	'frIwEI	
freeze	fri:z	
freeze-dry	'fri:z-dra:I	
freezer	'fri:z@	
freight	frEIt	
french	frEntS	
frenetic	fr@'nEtIk	
frenzy	'frEnzi:	
frequency	'fri:kw@nsi:	
frequent	'fri:kw@nt	
fresh	frES	
freshwater	'frESwo:t@	
fret	frEt	
friction	'frIkS@n	
friday	'fra:IdEI	
fridge	frIdZ	
fried	fra:Id	
friend	frEnd	
friendly	'frEndli:	
friendship	'frEndSIp	
fright	fra:It	
frighten	'fra:It@n	
frightful	'fra:ItfUl	
frill	frIl	
fringe	frIndZ	
frisk	frIsk	
fritter	'frIt@	
frivolous	'frIv@l@s	
frizzy	'frIzi:	
frock	frOk	
frog	frOɡ	
frogman	frOɡm@n	
frolic	'frOlIk	
from	frOm	
front	frant	
frontier	fran'tI@	
frost	frOst	
frostbite	'frOstba:It	
froth	frOT	
frown	fra:Un	
froze	fr@Uz	
frozen	'fr@Uz@n	
frugal	fru:ɡ@l	
fruit	fru:t	
fruitcake	'fru:tkEIk	
frustrate	fras'trEIt	
fry	fra:I	
fuck	fak	
fuckwit	'fakwIt	
fudge	fadZ	
fuel	'fju:@l	
fugitive	'fju:dZ@tIv	
fulfil	fUl'fIl	
full	fUl	
fullstop	fUl'stOp	
full-time	fUl-'ta:Im	
fully-fledged	'fUli:-flEdZd	
fumble	'famb@l	
fume	fju:m	
fumigate	fju:m@ɡEIt	
fun	fan	
function	'faNkS@n	
functional	'faNkS@n@l	
fund	fand	
fundamental	fand@'mEnt@l	
funeral	'fju:nr@l	
fungus	faNɡ@s	
funnel	'fan@l	
funnel-web	'fan@lwEb	
funny	'fani:	
fur	f@:	
furious	'fju:ri:@s	
furnace	'f@:n@s	
furnish	'f@:nIS	
furniture	'f@:nItS@	
furore	'fju:ro:	
furrow	'far@U	
further	'f@:D@	
furthest	'f@:D@st	
furtive	'f@:tIv	
fury	'fju:ri:	
fuse	fju:z	
fuss	fas	
fussy	'fasi:	
futile	'fju:ta:Il	
future	'fju:tS@	
futuretense	fju:tS@'tEns	
fuzz	faz	
fuzzy	'fazi:	
g	dZi:	
gable	ɡEIb@l	
gadget	ɡAdZ@t	
gag	ɡAɡ	
gaggle	ɡAɡ@l	
gaiety	ɡEI@ti:	
gain	ɡEIn	
gait	ɡEIt	
gala	ɡa:l@	
galah	ɡ@'la:	
galaxy	ɡAl@ksi:	
gale	ɡEIl	
gallbladder	ɡo:lblAd@	
gallery	ɡAl@ri:	
gallon	ɡAl@n	
gallop	ɡAl@p	
gallstone	ɡo:lst@Un	
galluppoll	ɡAl@pp@Ul	
galore	ɡ@'lo:	
galvanise	ɡAlv@na:Iz	
gamble	ɡAmb@l	
game	ɡEIm	
gaming	ɡEImIN	
gang	ɡAN	
gangrene	ɡANɡri:n	
gangster	ɡANst@	
gaol	dZEIl	
gap	ɡAp	
gape	ɡEIp	
garage	ɡAra:Z	
garbage	ɡa:bIdZ	
garden	ɡa:d@n	
gardener	ɡa:dn@	
gargle	ɡa:ɡ@l	
garish	ɡE@rIS	
garlic	ɡa:lIk	
garment	ɡa:m@nt	
garnish	ɡa:nIS	
garret	ɡAr@t	
gas	ɡAs	
gash	ɡAS	
gasket	ɡAsk@t	
gasp	ɡAsp	
gastric	ɡAstrIk	
gate	ɡEIt	
gatecrash	ɡEItkrAS	
gather	ɡAD@	
gaudy	ɡo:di:	
gauge	ɡEIdZ	
gaunt	ɡo:nt	
gauze	ɡo:z	
gave	ɡEIv	
gawk	ɡo:k	
gawky	ɡo:ki:	
gay	ɡEI	
gaze	ɡEIz	
gazump	ɡ@'zamp	
gdp	dZi:di:'pi:	
gear	ɡI@	
gel	dZEl	
gelatine	'dZEl@ti:n	
gem	dZEm	
gender	'dZEnd@	
gene	dZi:n	
general	'dZEnr@l	
generate	'dZEn@rEIt	
generation	dZEn@'rEIS@n	
generic	dZ@'nErIk	
generous	'dZEn@r@s	
genesis	'dZEn@s@s	
genetics	dZ@'nEtIks	
genial	'dZi:ni:@l	
genitals	'dZEn@t@lz	
genius	'dZi:ni:@s	
genocide	'dZEn@sa:Id	
genre	'ZOnr@	
gentile	'dZEnta:Il	
gentle	'dZEnt@l	
gentleman	'dZEnt@lm@n	
genuine	'dZEnju:@n	
geography	dZi:'Oɡr@fi:	
geology	dZi:'Ol@dZi:	
geometry	dZi:'Om@tri:	
geriatric	dZEri:'AtrIk	
geriatrics	dZEri:'AtrIks	
germ	dZ@:m	
german	'dZ@:m@n	
gerrymander	'dZEri:mAnd@	
gesticulate	dZEs'tIkj@lEIt	
gesture	'dZEstS@	
get	ɡEt	
ghastly	ɡa:stli:	
gherkin	ɡ@:k@n	
ghetto	ɡEt@U	
ghost	ɡ@Ust	
giant	'dZa:I@nt	
gibber	'dZIb@	
gibberish	'dZIb@rIS	
giddy	ɡIdi:	
gift	ɡIft	
gigantic	dZa:I'ɡAntIk	
giggle	ɡIɡ@l	
gild	ɡIld	
gilt	ɡIlt	
gimmick	ɡImIk	
ginger	'dZIndZ@	
gingerly	'dZIndZ@li:	
gingham	ɡIN@m	
gipsy	'dZIpsi:	
girl	ɡ@:l	
girlfriend	ɡ@:lfrEnd	
girls’	ɡ@:lz	
girth	ɡ@:T	
gist	dZIst	
give	ɡIv	
givenname	ɡIv@nnEIm	
glacier	ɡlEIsi:@	
glad	ɡlAd	
glamour	ɡlAm@	
glance	ɡlAns	
gland	ɡlAnd	
glare	ɡlE@	
glaring	ɡlE@rIN	
glass	ɡla:s	
gleam	ɡli:m	
glean	ɡli:n	
glee	ɡli:	
glib	ɡlIb	
glide	ɡla:Id	
glimmer	ɡlIm@	
glimpse	ɡlImps	
glint	ɡlInt	
glisten	ɡlIs@n	
glitter	ɡlIt@	
gloat	ɡl@Ut	
globe	ɡl@Ub	
gloomy	ɡlu:mi:	
glorious	ɡlo:ri:@s	
glory	ɡlo:ri:	
gloss	ɡlOs	
glossary	ɡlOs@ri:	
glove	ɡlav	
glow	ɡl@U	
glucose	ɡlu:k@Us	
glue	ɡlu:	
glum	ɡlam	
glut	ɡlat	
glutton	ɡlat@n	
gnash	nAS	
gnaw	no:	
gnp	dZi:En'pi:	
go	ɡ@U	
goal	ɡ@Ul	
goalkeeper	ɡ@Ulki:p@	
goat	ɡ@Ut	
gobble	ɡOb@l	
god	ɡOd	
goggle	ɡOɡ@l	
gold	ɡ@Uld	
golden	ɡ@Uld@n	
goldensyrup	ɡ@Uld@n'sIr@p	
goldmine	ɡ@Uldma:In	
golf	ɡOlf	
gone	ɡOn	
gonorrhoea	ɡOn@'ri:@	
good	ɡUd	
goodbye	ɡUd'ba:I	
goodness	ɡUdn@s	
goods	ɡUdz	
goose	ɡu:s	
gorge	ɡo:dZ	
gorgeous	ɡo:dZ@s	
gosh	ɡOS	
gossip	ɡOs@p	
got	ɡOt	
gouge	ɡa:UdZ	
gourmet	ɡo:mEI	
gout	ɡa:Ut	
govern	ɡav@n	
government	ɡav@nm@nt	
governor	ɡav@n@	
governor-general	ɡav@n@-'dZEnr@l	
gown	ɡa:Un	
gp	dZi:'pi:	
gpo	dZi:pi:'@U	
grab	ɡrAb	
grace	ɡrEIs	
gracious	ɡrEIS@s	
grade	ɡrEId	
gradual	ɡrAdZu:@l	
graduate	ɡrAdZu:@t	
graffiti	ɡr@'fi:ti:	
graft	ɡra:ft	
grain	ɡrEIn	
gram	ɡrAm	
grammar	ɡrAm@	
gran	ɡrAn	
grand	ɡrAnd	
grandchild	ɡrAntSa:Ild	
granddaughter	ɡrAndo:t@	
grandfather	ɡrAnfa:D@	
grandiose	ɡrAndi:@Us	
grandmother	ɡrAnmaD@	
grandparent	ɡrAnpE@r@nt	
grandson	ɡrAnsan	
grandstand	ɡrAnstAnd	
granite	ɡrAn@t	
grannysmith	ɡrAni:'smIT	
grant	ɡrAnt	
grape	ɡrEIp	
graph	ɡrAf	
graphic	ɡrAfIk	
graphite	ɡrAfa:It	
grapple	ɡrAp@l	
grasp	ɡrAsp	
grasping	ɡrAspIN	
grass	ɡra:s	
grassroots	ɡra:s'ru:ts	
grate	ɡrEIt	
grateful	ɡrEItfUl	
grater	ɡrEIt@	
grating	ɡrEItIN	
gratitude	ɡrAt@tSu:d	
grave	ɡrEIv	
gravel	ɡrAv@l	
graveyard	ɡrEIvja:d	
gravitate	ɡrAv@tEIt	
gravity	ɡrAv@ti:	
gravy	ɡrEIvi:	
graze	ɡrEIz	
grazier	ɡrEIzi:@	
grease	ɡri:s	
greaseproof	ɡri:spru:f	
great	ɡrEIt	
greedy	ɡri:di:	
greek	ɡri:k	
green	ɡri:n	
greengrocer	ɡri:nɡr@Us@	
greenhouse	ɡri:nha:Us	
greet	ɡri:t	
greeting	ɡri:tIN	
grenade	ɡr@'nEId	
grevillea	ɡr@'vIli:@	
grew	ɡru:	
grey	ɡrEI	
grid	ɡrId	
grief	ɡri:f	
grievance	ɡri:v@ns	
grill	ɡrIl	
grille	ɡrIl	
grim	ɡrIm	
grimace	ɡrIm@s	
grime	ɡra:Im	
grin	ɡrIn	
grind	ɡra:Ind	
grip	ɡrIp	
gripe	ɡra:Ip	
grisly	ɡrIzli:	
gristle	ɡrIs@l	
grit	ɡrIt	
grizzle	ɡrIz@l	
groan	ɡr@Un	
grocer	ɡr@Us@	
groceries	ɡr@Us@ri:z	
grog	ɡrOɡ	
groggy	ɡrOɡi:	
groin	ɡro:In	
groom	ɡru:m	
groomsman	ɡru:mzm@n	
groove	ɡru:v	
grope	ɡr@Up	
gross	ɡr@Us	
grotesque	ɡr@U'tEsk	
grotty	ɡrOti:	
grouch	ɡra:UtS	
ground	ɡra:Und	
groundwork	ɡra:Undw@:k	
group	ɡru:p	
grout	ɡra:Ut	
grove	ɡr@Uv	
grovel	ɡrOv@l	
grow	ɡr@U	
growl	ɡra:Ul	
grown	ɡr@Un	
growth	ɡr@UT	
grub	ɡrab	
grubby	ɡrabi:	
grudge	ɡradZ	
grudging	ɡradZIN	
gruelling	ɡru:@lIN	
gruesome	ɡru:s@m	
gruff	ɡraf	
grumble	ɡramb@l	
grumpy	ɡrampi:	
grunt	ɡrant	
guarantee	ɡAr@n'ti:	
guard	ɡa:d	
guardian	ɡa:di:@n	
guerilla	ɡ@'rIl@	
guess	ɡEs	
guest	ɡEst	
guffaw	ɡa'fo:	
guidance	ɡa:Id@ns	
guide	ɡa:Id	
guile	ɡa:Il	
guilt	ɡIlt	
guitar	ɡ@'ta:	
gulf	ɡalf	
gullet	ɡal@t	
gullible	ɡal@b@l	
gully	ɡali:	
gulp	ɡalp	
gum	ɡam	
gumboot	ɡambu:t	
gun	ɡan	
gurgle	ɡ@:ɡ@l	
gush	ɡaS	
gust	ɡast	
gusto	ɡast@U	
gut	ɡat	
gutter	ɡat@	
guy	ɡa:I	
guzzle	ɡaz@l	
gym	dZIm	
gymnasium	dZIm'nEIzi:@m	
gymnastics	dZIm'nAstIks	
gynaecologist	ɡa:In@'kOl@dZ@st	
gypsy	'dZIpsi:	
h	EItS	
habit	'hAb@t	
habitat	'hAb@tAt	
hack	hAk	
hacksaw	hAkso:	
had	hAd	
hadn't	'hAd@nt	
haemoglobin	'hi:m@ɡl@Ub@n	
haemophilia	hi:m@'fIli:@	
haemorrhage	'hEm@rIdZ	
haemorrhoid	'hEm@ro:Id	
haggard	hAɡ@d	
haggle	hAɡ@l	
hail	hEIl	
hair	hE@	
hair-raising	'hE@rEIzIN	
haircut	'hE@kat	
hairdo	'hE@du:	
hairdresser	'hE@drEs@	
hairstyle	'hE@sta:Il	
half	ha:f	
half-brother	'ha:f-braD@	
half-hearted	'ha:f-ha:t@d	
half-sister	'ha:f-sIst@	
halfway	'ha:fwEI	
hall	ho:l	
hallmark	'ho:lma:k	
hallucinate	h@'lu:s@nEIt	
hallway	'ho:lwEI	
halo	'hEIl@U	
halt	ho:lt	
halve	ha:v	
ham	hAm	
hamburger	hAmb@:ɡ@	
hammer	'hAm@	
hammock	'hAm@k	
hamper	'hAmp@	
hamstring	'hAmstrIN	
hand	hAnd	
handbag	hAndbAɡ	
handcuffs	'hAndkafs	
handful	'hAndfUl	
handicap	'hAndi:kAp	
handicraft	'hAndi:kra:ft	
handkerchief	'hANk@tS@f	'hANk@tSi:f
handle	'hAnd@l	
handmade	hAnmEId	
handout	'hAnda:Ut	
hands-on	hAndz-'On	
handshake	'hAndSEIk	
handsome	'hAns@m	
handwriting	'hAndra:ItIN	
handy	'hAndi:	
hang	hAN	
hang-glider	hAN-ɡla:Id@	
hang-up	'hAN-ap	
hangar	'hAN@	
hanger	'hAN@	
hangover	'hAN@Uv@	
hankie	'hANki:	
haphazard	hAp'hAz@d	
happen	'hAp@n	
happy	'hApi:	
harass	'hAr@s	h@'rAs
harbour	'ha:b@	
hard	ha:d	
hardly	'ha:dli:	
hardship	'ha:dSIp	
hardware	'ha:dwE@	
hardy	'ha:di:	
harm	ha:m	
harmony	'ha:m@ni:	
harness	'ha:n@s	
harp	ha:p	
harpoon	ha:'pu:n	
harsh	ha:S	
harvest	'ha:v@st	
has	hAz	
hash	hAS	
hassle	'hAs@l	
haste	hEIst	
hat	hAt	
hat-trick	'hAt-trIk	
hatch	hAtS	
hatchback	'hAtSbAk	
hatchet	'hAtS@t	
hate	hEIt	
haughty	'ho:ti:	
haul	ho:l	
haunt	ho:nt	
have	hAv	
haven	'hEIv@n	
havoc	'hAv@k	
hawk	ho:k	
hay	hEI	
hayfever	'hEIfi:v@	
haywire	'hEIwa:I@	
hazard	'hAz@d	
haze	hEIz	
hazel	'hEIz@l	
he	hi:	
head	hEd	
headstart	hEd'sta:t	
head-on	hEd-'On	
headache	'hEdEIk	
heading	'hEdIN	
headland	'hEdl@nd	'hEdlAnd
headlight	'hEdla:It	
headline	'hEdla:In	
headquarters	'hEdkwo:t@z	
headstone	'hEdst@Un	
headstrong	'hEdstrON	
headteacher	'hEdti:tS@	hEd'ti:tS@
headway	'hEdwEI	
headwind	'hEdwInd	
heal	hi:l	
health	hElT	
heap	hi:p	
hear	hI@	
hearing	'hI@rIN	
hearingaid	'hI@rINEId	
hearsay	'hI@sEI	
hearse	h@:s	
heart	ha:t	
heartache	'ha:tEIk	
heartbreak	'ha:tbrEIk	
heartburn	'ha:tb@:n	
hearten	'ha:t@n	
heartless	'ha:tl@s	
hearty	'ha:ti:	
heat	hi:t	
heater	'hi:t@	
heatwave	'hi:twEIv	
heave	hi:v	
heaven	'hEv@n	
heavy	'hEvi:	
heckle	'hEk@l	
hectare	'hEktE@	
hectic	'hEktIk	
hedge	hEdZ	
heel	hi:l	
hefty	'hEfti:	
heifer	'hEf@	
height	ha:It	
heighten	'ha:It@n	
heights	ha:Its	
heir	E@	
heirloom	'E@lu:m	
held	hEld	
helicopter	'hEli:kOpt@	
heliport	'hEli:po:t	
hell	hEl	
hello	ha'l@U	
helm	hElm	
helmet	'hElm@t	
help	hElp	
helping	'hElpIN	
helpless	'hElpl@s	
hem	hEm	
hemisphere	'hEm@sfI@	
hemline	'hEmla:In	
hemp	hEmp	
hen	hEn	
hence	hEns	
henceforth	hEns'fo:T	
hepatitis	hEp@'ta:It@s	
her	h@:	
herald	'hEr@ld	
herb	h@:b	
herd	h@:d	
here	hI@	
heredity	h@'rEd@ti:	
heresy	'hEr@si:	
heritage	'hEr@tIdZ	
hermit	'h@:m@t	
hernia	'h@:ni:@	
hero	'hI@r@U	
heroin	'hEr@w@n	
heroine	'hEr@w@n	
herpes	'h@:pi:z	
hers	h@:z	
herself	h@'sElf	
hesitate	'hEz@tEIt	
heterosexual	hEt@r@U'sEkSu:@l	hEtr@'sEkSu:@l
hew	hju:	
heyday	'hEIdEI	
hi-fi	'ha:I-fa:I	
hibernate	'ha:Ib@nEIt	
hiccup	'hIkap	
hidden	'hId@n	
hide	ha:Id	
hideaway	'ha:Id@wEI	
hideous	'hIdi:@s	
hierarchy	'ha:I@ra:ki:	
high	ha:I	
highschool	'ha:Isku:l	
highseason	'ha:Isi:z@n	
highbrow	'ha:Ibra:U	
highland	'ha:Il@nd	
highlight	'ha:Ila:It	
highlighter	'ha:Ila:It@	
highly	'ha:Ili:	
highway	'ha:IwEI	
hijack	'ha:IdZAk	
hike	ha:Ik	
hilarious	h@'lE@ri:@s	
hill	hIl	
hilt	hIlt	
him	hIm	
himself	hIm'sElf	
hind	ha:Ind	
hinder	'hInd@	
hindsight	'ha:Indsa:It	
hinduism	'hIndu:Iz@m	
hinge	hIndZ	
hint	hInt	
hip	hIp	
hire	'ha:I@	
hire-purchase	ha:I@-'p@:tS@s	
his	hIz	
hiss	hIs	
historic	hI'stOrIk	
historical	hI'stOrIk@l	
history	'hIstri:	
hit	hIt	
hit-and-run	hIt-@n-'ran	
hitch	hItS	
hitchhike	'hItSha:Ik	
hitherto	'hID@tu:	
hive	ha:Iv	
hoard	ho:d	
hoarding	'ho:dIN	
hoarse	ho:s	
hoax	h@Uks	
hobble	'hOb@l	
hobby	'hObi:	
hobbyhorse	'hObi:ho:s	
hockey	'hOki:	
hoe	h@U	
hog	hOɡ	
hoist	ho:Ist	
hold	h@Uld	
hold-up	'h@Uld-ap	
hole	h@Ul	
holiday	'hOl@dEI	
hollow	'hOl@U	
holocaust	'hOl@kOst	
hologram	hOl@ɡrAm	
holster	'h@Ulst@	
holy	'h@Uli:	
homage	'hOmIdZ	
home	h@Um	
homeunit	'h@Umju:n@t	
homeland	'h@UmlAnd	
homesick	'h@UmsIk	
homestead	'h@UmstEd	
homework	'h@Umw@:k	
homicide	'hOm@sa:Id	
homoeopathy	h@Umi:'Op@Ti:	
homogeneous	h@Um@'dZi:ni:@s	
homosexual	h@Um@U'sEkSu:@l	h@Um@'sEkSu:@l
honest	'On@st	
honey	'hani:	
honeycomb	'hani:k@Um	
honeymoon	'hani:mu:n	
honorary	'On@r@ri:	
honour	'On@	
honourable	'On@r@b@l	
hood	hUd	
hoodlum	'hu:dl@m	
hoodwink	'hUdwINk	
hoof	hu:f	hUf
hook	hUk	
hooligan	hu:l@ɡ@n	'hu:li:ɡ@n
hoon	hu:n	
hoop	hu:p	
hop	hOp	
hope	h@Up	
hopeful	'h@UpfUl	
hopeless	'h@Upl@s	
horde	ho:d	
horizon	h@'ra:Iz@n	
horizontal	hOr@'zOnt@l	
hormone	'ho:m@Un	
horn	ho:n	
horoscope	'hOr@sk@Up	
horrendous	h@'rEnd@s	
horrible	'hOr@b@l	
horrify	'hOr@fa:I	
horror	'hOr@	
horsdoeuvre	o:'d@:v	
horse	ho:s	
horseshoe	'ho:sSu:	
horticulture	'ho:t@kaltS@	
hose	h@Uz	
hosiery	'h@UZ@ri:	
hospice	'hOsp@s	
hospital	'hOsp@t@l	
hospitality	hOsp@'tAl@ti:	
host	h@Ust	
hostage	'hOstIdZ	
hostel	'hOst@l	hOs'tEl
hostile	'hOsta:Il	
hot	hOt	
hotchips	hOt'tSIps	
hotdog	hOtdOɡ	
hotel	h@UtEl	
hothouse	'hOtha:Us	
hotline	'hOtla:In	
hotplate	'hOtplEIt	
hound	ha:Und	
hour	a:U@	
house	ha:Us	
house-warming	'ha:Us-wo:mIN	
housebreaker	'ha:UsbrEIk@	
household	'ha:Ush@Uld	
housekeeping	'ha:Uski:pIN	
housewife	'ha:Uswa:If	
housework	'ha:Usw@:k	
hovel	'hOv@l	
hover	'hOv@	
hovercraft	'hOv@kra:ft	
how	ha:U	
however	ha:U'Ev@	
howl	ha:Ul	
hq	EItS'kju:	
hr	a:U@	
hsc	EItSEs'si:	
ht	ha:It	
hub	hab	
huddle	'had@l	
hue	hju:	
hug	haɡ	
huge	hju:dZ	
hulk	halk	
hull	hal	
hullo	'hal@U	
hum	ham	
human	'hju:m@n	
humane	hju:;'mEIn	
humanitarian	hju:;mAn@'tE@ri:@n	
humanity	hju:'mAn@ti:	
humble	'hamb@l	
humdrum	'hamdram	
humid	'hju:m@d	
humiliate	hju:'mIli:EIt	
humility	hju:'mIl@ti:	
humour	'hju:m@	
hump	hamp	
humpy	'hampi:	
hunch	hantS	
hundred	'handr@d	
hung	haN	
hungarian	haN'ɡE@ri:@n	
hunger	haNɡ@	
hunt	hant	
hurdle	'h@:d@l	
hurl	h@:l	
hurray	h@'rEI	
hurricane	'har@k@n	
hurry	'hari:	
hurt	h@:t	
hurtful	'h@:tfUl	
hurtle	'h@:t@l	
husband	'hazb@nd	
hush	haS	
husk	hask	
husky	'haski:	
hustle	'has@l	
hut	hat	
hutch	hatS	
hwy	'ha:IwEI	
hybrid	'ha:Ibr@d	
hydrant	'ha:Idr@nt	
hydraulic	ha:I'drOlIk	
hydro-electric	ha:Idr@U-@'lEktrIk	
hydrofoil	'ha:Idr@fo:Il	
hydroponics	ha:Idr@'pOnIks	
hygiene	'ha:IdZi:n	
hymn	hIm	
hype	ha:Ip	
hyped-up	'ha:Ipt-ap	
hyphen	'ha:If@n	
hypnosis	hIp'n@Us@s	
hypochondriac	ha:Ip@'kOndri:Ak	
hypocrite	'hIp@krIt	
hypodermic	ha:Ip@'d@:mIk	
hypothesis	ha:I'pOT@s@s	
hysterectomy	hIst@'rEkt@mi:	
hysteria	hIs'tI@ri:@	
i	a:I	
ie	a:I'i:	
ice	a:Is	
ice-cream	'a:Is-kri:m	
iceberg	a:Isb@:ɡ	
icicle	'a:IsIk@l	
icing	'a:IsIN	
id	a:I'di:	
idea	a:I'dI@	
ideal	a:I'di:l	
identical	a:I'dEntIk@l	
identification	a:I;dEnt@f@'kEIS@n	
identify	a:I'dEnt@fa:I	
identity	a:I'dEnt@ti:	
idiom	'Idi:@m	
idiot	'Idi:@t	
idle	'a:Id@l	
idol	'a:Id@l	
if	If	
ignite	Iɡ'na:It	
ignition	Iɡ'nIS@n	
ignorant	Iɡn@r@nt	
ignore	Iɡ'no:	
ill	Il	
illegal	I'li:ɡ@l	
illegible	I'lEdZ@b@l	
illegitimate	Il@'dZIt@m@t	
illicit	I'lIs@t	
illiterate	I'lIt@r@t	
illuminate	I'lu:m@nEIt	
illusion	I'lu:Z@n	
illustrate	'Il@strEIt	
image	'ImIdZ	
imaginary	I'mAdZ@n@ri:	@'mAdZ@nri:
imagination	ImAdZ@'nEIS@n	@mAdZ@'nEIS@n
imagine	I'mAdZ@n	@'mAdZ@n
imam	'Ima:m	
imbecile	'Imb@si:l	
imitate	'Im@tEIt	
immaculate	I'mAkju:l@t	@'mAkj@l@t
immature	'Im@tSU@	
immediate	I'mi:di:@t	
immense	I'mEns	
immerse	I'm@:s	
immigrant	Im@ɡr@nt	
imminent	'Im@n@nt	
immoral	I'mOr@l	
immortal	I'mo:t@l	
immune	I'mju:n	
impact	'ImpAkt	
impair	Im'pE@	
impartial	Im'pa:S@l	
impatient	Im'pEIS@nt	
impede	Im'pi:d	
imperative	Im'pEr@tIv	
imperfect	Im'p@:fIkt	
imperial	Im'pI@ri:@l	
impersonal	Im'p@:s@n@l	
impersonate	Im'p@:s@nEIt	
impertinent	Im'p@:t@n@nt	
impetuous	Im'pEtju:@s	Im'pEtSu:@s
implement	'Impl@m@nt	
implicate	'Impl@kEIt	
implication	Impl@'kEIS@n	
implicit	Im'plIs@t	
implore	Im'plo:	
imply	Im'pla:I	
impolite	Imp@'la:It	
import	Im'po:t	
important	Im'po:t@nt	
impose	Im'p@Uz	
imposing	Im'p@UzIN	
impossible	Im'pOs@b@l	
imposter	Im'pOst@	
impotent	'Imp@t@nt	
impress	Im'prEs	
impression	Im'prES@n	
imprison	Im'prIz@n	
improve	Im'pru:v	
impudent	'Impju:d@nt	
impulse	'Impals	
impure	Im'pjU@	
in	In	
in-	In-	
in-laws	'In-lo:z	
in-patient	'In-pEIS@nt	
inaccurate	In'Akj@r@t	
inadequate	In'Ad@kw@t	
inane	In'EIn	
inanimate	In'An@m@t	
inappropriate	In@'pr@Upri:@t	
incapacitate	Ink@'pAs@tEIt	
incentive	In'sEntIv	
incessant	In'sEs@nt	
incest	'InsEst	
inch	IntS	
incidence	'Ins@d@ns	
incident	'Ins@d@nt	
incidental	Ins@'dEnt@l	
incinerate	In'sIn@rEIt	
incite	In'sa:It	
incline	'INkla:In	
inclined	IN'kla:Ind	
include	IN'klu:d	
inclusive	IN'klu:sIv	
incoherent	INk@U'hI@r@nt	
income	'Inkam	'INkam
incoming	'InkamIN	'INkamIN
incompetent	IN'kOmp@t@nt	
inconvenient	INk@n'vi:ni:@nt	
incorporate	IN'ko:p@rEIt	
increase	IN'kri:s	
incredible	IN'krEd@b@l	
incur	IN'k@:	
indebted	In'dEt@d	
indecent	In'di:s@nt	
indeed	In'di:d	
indefinite	In'dEf@n@t	
indent	In'dEnt	'IndEnt
independent	Ind@'pEnd@nt	
index	'IndEks	
indicate	'Ind@kEIt	
indicator	'Ind@kEIt@	
indifferent	In'dIfr@nt	
indigenous	In'dIdZ@n@s	
indigestion	Ind@'dZEstS@n	
indignant	In'dIɡn@nt	
indispensable	Ind@s'pEns@b@l	
indisposed	Ind@s'p@Uzd	
indisputable	Ind@s'pju:t@b@l	
individual	Ind@'vIdZu:@l	
indoctrinate	In'dOktr@nEIt	
indolent	'Ind@l@nt	
indonesian	Ind@'ni:Z@n	
indoors	In'do:z	
induce	In'dju:s	
indulge	In'daldZ	
industry	'Ind@stri:	
inept	In'Ept	
inevitable	In'Ev@t@b@l	
inevitably	In'Ev@t@bli:	
inexperience	In@k'spI@ri:@ns	
infamous	'Inf@m@s	
infant	'Inf@nt	
infatuated	In'fAtSu:EIt@d	
infection	In'fEkS@n	
infectious	In'fEkS@s	
infer	In'f@:	
inferior	In'fI@ri:@	
infest	In'fEst	
infidelity	Inf@'dEl@ti:	
infiltrate	'Inf@ltrEIt	
infinite	'Inf@n@t	
infinitive	In'fIn@tIv	
inflame	In'flEIm	
inflammable	In'flAm@b@l	
inflate	In'flEIt	
inflation	In'flEIS@n	
inflect	In'flEkt	
inflexible	In'flEks@b@l	
inflict	In'flIkt	
influence	'Influ:@ns	
influenza	Influ:'Enz@	
influx	'Inflaks	
inform	In'fo:m	
informal	In'fo:m@l	
information	Inf@'mEIS@n	
infuriate	In'fju:ri:EIt	
ingenious	In'dZi:ni:@s	
ingrained	InɡrEInd	
ingratiate	In'ɡrEISi:EIt	
ingratitude	In'ɡrAt@tSu:d	
ingredient	In'ɡri:di:@nt	
inhabit	In'hAb@t	
inhale	In'hEIl	
inherit	In'hEr@t	
initial	I'nIS@l	
initiate	I'nISi:EIt	
initiative	I'nISi:@tIv	@'nIS@tIv
inject	In'dZEkt	
injure	'IndZ@	
injustice	In'dZast@s	
ink	INk	
inkling	'INklIN	
inlaid	'InlEId	
inland	'InlAnd	
inmate	'InmEIt	
inner	'In@	
innings	'InINz	
innocent	'In@s@nt	
innumerable	I'nju:m@r@b@l	
inoculate	I'nOkju:lEIt	In'Okj@lEIt
inquest	'INkwEst	
inquire	IN'kwa:I@	
inquisitive	IN'kwIz@tIv	
insandouts	Inz@n'a:Uts	
insane	In'sEIn	
insect	'InsEkt	
insecticide	In'sEkt@sa:Id	
insecure	Ins@'kju:@	
insensitive	In'sEns@tIv	
insert	In's@:t	
inside	In'sa:Id	
insinuate	In'sInju:EIt	
insipid	In'sIp@d	
insist	In'sIst	
insolent	'Ins@l@nt	
inspect	In'spEkt	
inspire	In'spa:I@	
install	In'sto:l	
instalment	In'sto:lm@nt	
instance	'Inst@ns	
instant	'Inst@nt	
instead	In'stEd	
instinct	'InstINkt	
institute	'Inst@tSu:t	
institution	Inst@'tju:S@n	
instruct	In'strakt	
instruction	In'strakS@n	
instrument	'Instr@m@nt	
insubordinate	Ins@'bo:d@n@t	
insubstantial	Ins@b'stAnS@l	
insufferable	In'saf@r@b@l	
insulate	'InS@lEIt	
insulin	'InS@l@n	
insult	In'salt	
insure	In'So:	
intact	In'tAkt	
integral	Int@ɡr@l	
integrate	Int@ɡrEIt	
integrity	In'tEɡr@ti:	
intellect	'Int@lEkt	
intelligence	In'tEl@dZ@ns	
intelligent	In'tEl@dZ@nt	
intend	In'tEnd	
intense	In'tEns	
intensive	In'tEnsIv	
intention	In'tEnS@n	
interact	Int@r'Akt	
intercept	Int@'sEpt	'Int@sEpt
intercourse	'Int@ko:s	
interest	'Intr@st	
interesting	'Intr@stIN	
interfere	Int@'fI@	
interim	'Int@r@m	
interior	In'tI@ri:@	
interjection	Int@'dZEkS@n	
interlude	'Int@lu:d	
intermediate	Int@'mi:di:@t	
intermission	Int@'mIS@n	
intermittent	Int@'mIt@nt	
internal	In't@:n@l	
international	Int@'nAS@n@l	
interpret	In't@:pr@t	
interrogate	In'tEr@ɡEIt	
interrogative	Int@'rOɡ@tIv	
interrupt	Int@'rapt	
intersection	'Int@sEkS@n	
interstate	'Int@stEIt	
interval	'Int@v@l	
intervene	Int@'vi:n	
interview	'Int@vju:	
intestine	In'tEst@n	
intimate	'Int@m@t	
intimidate	In'tIm@dEIt	
into	'Intu:	
intonation	Int@'nEIS@n	
intoxicated	In'tOks@kEIt@d	
intransitive	In'trAnz@tIv	
intravenous	Intr@'vi:n@s	
intrigue	In'tri:ɡ	
introduce	Intr@'dju:s	
introduction	Intr@'dakS@n	
intrude	In'tru:d	
intuition	IntSu:'IS@n	
invade	In'vEId	
invalid	In'vAl@d	'Inv@lId
invalidpension	Inv@lId'pEnS@n	
invaluable	In'vAlj@b@l	
invent	In'vEnt	
invertedcomma	Inv@:t@d'kOm@	
invest	In'vEst	
investigate	In'vEst@ɡEIt	
invigorate	In'vIɡ@rEIt	
invisible	In'vIz@b@l	
invite	In'va:It	
invoice	'Invo:Is	
involve	In'vOlv	
involved	In'vOlvd	
iou	a:I@U'ju:	
irate	a:I'rEIt	
iris	'a:Ir@s	
irk	@:k	
iron	'a:I@n	
irony	'a:Ir@ni:	
irrational	I'rAS@n@l	
irregular	I'rEɡj@l@	
irrelevant	I'rEl@v@nt	
irrigate	Ir@ɡEIt	
irritate	'Ir@tEIt	
is	Iz	
islam	'IzlAm	
island	'a:Il@nd	
isolate	'a:Is@lEIt	
issue	'ISu:	
it	It	
italian	I'tAlj@n	
italics	I'tAlIks	
itch	ItS	
item	'a:It@m	
itinerary	a:I'tIn@ri:	
its	Its	
itself	It'sElf	
ive	a:Iv	
ivy	'a:Ivi:	
j	dZEI	
jab	dZAb	
jabber	'dZAb@	
jabiru	dZAb@'ru:	
jack	dZAk	
jackeroo	dZAk@'ru:	
jacket	'dZAk@t	
jackknife	'dZAkna:If	
jackpot	'dZAkpOt	
jade	dZEId	
jaded	'dZEId@d	
jagged	dZAɡ@d	
jail	dZEIl	
jam	dZAm	
jamb	dZAm	
jan	'dZAnju:@ri:	
jangle	dZANɡ@l	
january	'dZAnju:@ri:	
japanese	dZAp@'ni:z	
jar	dZa:	
jargon	dZa:ɡ@n	
jarrah	'dZAr@	
jaundice	'dZo:nd@s	
jaunt	dZo:nt	
jaunty	'dZo:nti:	
javelin	'dZAv@l@n	
jaw	dZo:	
jaywalk	'dZEIwo:k	
jazz	dZAz	
jealous	'dZEl@s	
jeans	dZi:nz	
jeep	dZi:p	
jeer	dZI@	
jelly	'dZEli:	
jellyfish	'dZEli:fIS	
jeopardy	'dZEp@di:	
jerk	dZ@:k	
jersey	'dZ@:zi:	
jet	dZEt	
jettison	'dZEt@s@n	
jetty	'dZEti:	
jewel	'dZu:@l	
jewellery	'dZu:@lri:	
jewish	'dZu:IS	
jibe	dZa:Ib	
jiffy	'dZIfi:	
jig	dZIɡ	
jiggle	dZIɡ@l	
jigsaw	dZIɡso:	
jillaroo	dZIl@'ru:	
jilt	dZIlt	
jingle	dZINɡ@l	
jinx	dZINks	
jitters	'dZIt@z	
jive	dZa:Iv	
jnr	'dZu:nj@	
job	dZOb	
jobless	'dZObl@s	
jockey	'dZOki:	
jocular	'dZOkj@l@	
jodhpurs	'dZOdp@z	
joey	'dZ@Ui:	
jog	dZOɡ	
join	dZo:In	
joiner	'dZo:In@	
joint	dZo:Int	
joist	dZo:Ist	
joke	dZ@Uk	
joker	'dZ@Uk@	
jolly	'dZOli:	
jolt	dZ@Ult	
jostle	'dZOs@l	
jot	dZOt	
jotter	'dZOt@	
joule	dZu:l	
journal	'dZ@:n@l	
journalist	'dZ@:n@l@st	
journey	'dZ@:ni:	
jovial	'dZ@Uvi:@l	
joy	dZo:I	
jp	dZEI'pi:	
jube	dZu:b	
jubilant	'dZu:b@l@nt	
jubilee	dZu:b@'li:	
judaism	'dZu:dEIIz@m	
judge	dZadZ	
judgment	'dZadZm@nt	
judicial	dZu:'dIS@l	
judicious	dZu:'dIS@s	
judo	'dZu:d@U	
jug	dZaɡ	
juggle	dZaɡ@l	
juice	dZu:s	
jukebox	'dZu:kbOks	
jul	dZ@'la:I	
july	dZ@'la:I	
jumble	'dZamb@l	
jumbo	'dZamb@U	
jumbuck	'dZambak	
jump	dZamp	
jumper	'dZamp@	
jumpy	'dZampi:	
jun	dZu:n	
junction	'dZaNkS@n	
juncture	'dZaNktS@	
june	dZu:n	
jungle	dZaNɡ@l	
junior	'dZu:nj@	
junk	dZaNk	
junkie	'dZaNki:	
junta	'dZant@	
jurisdiction	dZu:r@s'dIkS@n	
jury	'dZu:ri:	
just	dZast	
justice	'dZast@s	
justiceofthepeace	dZast@s@vD@'pi:s	
justify	'dZast@fa:I	
jut	dZat	
jute	dZu:t	
juvenile	'dZu:v@na:Il	
juxtapose	dZakst@'p@Uz	
k	kEI	
kaleidoscope	k@'la:Id@sk@Up	
kangaroo	kANɡ@'ru:	
karate	k@'ra:ti:	
kayak	'ka:IAk	
kebab	k@'bAb	
keel	ki:l	
keen	ki:n	
keep	ki:p	
keeper	'ki:p@	
keeping	'ki:pIN	
keepsake	'ki:psEIk	
keg	kEɡ	
kelp	kElp	
kennel	'kEn@l	
kept	kEpt	
kerb	k@:b	
kernel	'k@:n@l	
kero	'kEr@U	
kerosene	kEr@'si:n	
ketchup	'kEtS@p	
kettle	'kEt@l	
key	ki:	
keyboard	'ki:bo:d	
keynote	'ki:n@Ut	
kg	kEI'dZi:	
khaki	ka:'ki:	
khmer	k@'mE@	
kibble	'kIb@l	
kick	kIk	
kid	kId	
kidnap	'kIdnAp	
kidney	'kIdni:	
kill	kIl	
killing	'kIlIN	
kiln	kIln	
kilo	'ki:l@U	
kilobyte	'kIl@ba:It	
kilogram	kIl@ɡrAm	
kilohertz	'kIl@h@:ts	
kilojoule	'kIl@dZu:l	
kilometre	k@'lOm@t@	'kIl@mi:t@
kilowatt	'kIl@wOt	
kilt	kIlt	
kimono	'kIm@n@U	k@'m@Un@U
kin	kIn	
kind	ka:Ind	
kindergarten	kInd@ɡa:t@n	
kindle	'kInd@l	
kindling	'kIndlIN	
kindly	'ka:Indli:	
kindred	'kIndr@d	
kindy	'kIndi:	
king	kIN	
kingdom	'kINd@m	
kink	kINk	
kinship	'kInSIp	
kiosk	'ki:Osk	
kiss	kIs	
kit	kIt	
kitchen	'kItS@n	
kitchentea	kItS@n'ti:	
kitchenette	kItS@'nEt	
kite	ka:It	
kitsch	kItS	
kitten	'kIt@n	
kiwi	'ki:wi:	
kj	'kIl@dZu:l	
kleptomania	klEpt@'mEIni:@	
km	k@'lOm@t@	'kIl@mi:t@
knack	nAk	
knackered	'nAk@d	
knapsack	'nApsAk	
knave	nEIv	
knead	ni:d	
knee	ni:	
kneecap	'ni:kAp	
kneel	ni:l	
knew	nju:	
knick-knack	'nIk-nAk	
knickers	'nIk@z	
knife	na:If	
knight	na:It	
knit	nIt	
knitting	nItIN	
knob	nOb	
knock	nOk	
knot	nOt	
know	n@U	
knowing	'n@UIN	
knowledge	'nOlIdZ	
known	n@Un	
knuckle	'nak@l	
ko	kEI'@U	
koala	k@Ua:l@	
kookaburra	'kUk@bar@	
korean	k@'ri:@n	
kosher	'k@US@	
kung-fu	kaN-'fu:	
l	El	
l-plate	'El-plEIt	
la	lEIn	'la:
label	'lEIb@l	
labor	'lEIb@	
laborparty	'lEIb@pa:ti:	
laboratory	l@'bOr@tri:	
labour	'lEIb@	
lace	lEIs	
lacerate	'lAs@rEIt	
lack	lAk	
lacquer	'lAk@	
lad	lAd	
ladder	'lAd@	
lady	'lEIdi:	
lag	lAɡ	
lager	la:ɡ@	
lagoon	l@'ɡu:n	
laid	lEId	
lake	lEIk	
lamb	lAm	
lame	lEIm	
laminate	'lAm@nEIt	
lamington	'lAmINt@n	
land	lAnd	
landlady	'lAndlEIdi:	
landlord	'lAndlo:d	
landmark	'lAndma:k	
landscape	'lAndskEIp	
landslide	'lAndsla:Id	
lane	lEIn	
language	'lANwIdZ	'lANɡwIdZ
lank	lANk	
lanky	'lANki:	
lantern	'lAnt@n	
lao	la:U	
lap	lAp	
lapse	lAps	
large	la:dZ	
larrikin	'lAr@k@n	
laryngitis	lAr@n'dZa:It@s	
larynx	'lArINks	
laser	'lEIz@	
lash	lAS	
last	la:st	
latch	lAtS	
late	lEIt	
lately	'lEItli:	
later	'lEIt@	
latest	'lEIt@st	
lather	'lAD@	
latin	'lAt@n	
latitude	'lAt@tSu:d	
latter	'lAt@	
lattice	'lAt@s	
laugh	la:f	
launch	lo:ntS	
laundromat	'lo:ndr@mAt	
laundry	'lo:ndri:	
lavatory	'lAv@tri:	
lavender	'lAv@nd@	
lavish	'lAvIS	
law	lo:	
lawful	'lo:f@l	
lawn	lo:n	
lawnmower	'lo:nm@U@	
lawyer	'lo:I@	
lax	lAks	
laxative	'lAks@tIv	
lay	lEI	
lay-by	'lEI-ba:I	
layer	'lEI@	
layout	'lEIa:Ut	
lazy	'lEIzi:	
lead	li:d	'lEd
leader	'li:d@	
leaf	li:f	
league	li:ɡ	
leak	li:k	
lean	li:n	
leant	lEnt	
leap	li:p	
leapt	lEpt	
learn	l@:n	
lease	li:s	
leash	li:S	
least	li:st	
leather	'lED@	
leave	li:v	
lecture	'lEktS@	
led	lEd	
ledge	lEdZ	
ledger	'lEdZ@	
leer	lI@	
left	lEft	
left-handed	lEft-'hAnd@d	
leg	lEɡ	
legal	li:ɡ@l	
legend	'lEdZ@nd	
leggings	lEɡINz	
legible	'lEdZ@b@l	
legislation	lEdZ@'slEIS@n	
legitimate	l@'dZIt@m@t	
leisure	'lEZ@	
lemon	'lEm@n	
lemonade	lEm@n'EId	
lend	lEnd	
length	lENT	lENkT
lengthen	'lENT@n	'lENkT@n
lenient	'li:ni:@nt	
lens	lEnz	
lent	lEnt	
leotard	'li:@ta:d	
lesbian	'lEzbi:@n	
less	lEs	
lessen	'lEs@n	
lesson	'lEs@n	
let	lEt	
lethal	'li:T@l	
letter	'lEt@	
leukaemia	lu:'ki:mi:@	
level	'lEv@l	
lever	'li:v@	
levy	'lEvi:	
liability	la:I@'bIl@ti:	
liable	'la:I@b@l	
liaison	li:'EIz@n	li:'EIzOn
liar	'la:I@	
libel	'la:Ib@l	
liberal	'lIbr@l	
liberalpartyofaustralia	lIbr@lpa:ti:@vOs'trEIlj@	
liberate	'lIb@rEIt	
liberty	'lIb@ti:	
library	'la:Ibri:	
lice	la:Is	
licence	'la:Is@ns	
lick	lIk	
licorice	'lIk@rIS	
lid	lId	
lie	la:I	
life	la:If	
lifelong	'la:IflON	
lifesaver	'la:IfsEIv@	
lifetime	'la:Ifta:Im	
lift	lIft	
light	la:It	
lightning	'la:ItnIN	
like	la:Ik	
likely	'la:Ikli:	
limb	lIm	
lime	la:Im	
limelight	'la:Imla:It	
limestone	'la:Imst@Un	
limit	'lIm@t	
limitedcompany	;lIm@t@d'kamp@ni:	
limp	lImp	
line	la:In	
linen	'lIn@n	
liner	'la:In@	
linger	lINɡ@	
lingerie	'lOnZ@rEI	
linguistic	lIN'ɡwIstIk	
liniment	'lIn@m@nt	
lining	'la:InIN	
link	lINk	
linoleum	l@'n@Uli:@m	
linseedoil	'lInsi:do:Il	
lip	lIp	
lipstick	'lIpstIk	
liquefy	'lIkw@fa:I	
liqueur	l@'kju:@	
liquid	'lIkw@d	
liquidate	'lIkw@dEIt	
liquor	'lIk@	
lisp	lIsp	
list	lIst	
listen	'lIs@n	
listless	'lIstl@s	
lit	lIt	
literal	'lItr@l	
literary	'lIt@r@ri:	
literate	'lIt@r@t	
literature	'lItr@tS@	
litre	'li:t@	
litter	'lIt@	
litterbug	lIt@baɡ	
little	'lIt@l	
live	lIv	
livelihood	'la:Ivli:;hUd	
lively	'la:Ivli:	
liver	'lIv@	
livestock	'la:IvstOk	
livid	'lIv@d	
living	'lIvIN	
lizard	'lIz@d	
load	l@Ud	
loaf	l@Uf	
loam	l@Um	
loan	l@Un	
loath	l@UT	
loathe	l@UD	
lob	lOb	
lobby	'lObi:	
local	'l@Uk@l	
locate	l@U'kEIt	
lock	lOk	
locker	'lOk@	
locket	'lOk@t	
locksmith	'lOksmIT	
locomotive	l@Uk@'m@UtIv	
lodge	lOdZ	
loft	lOft	
lofty	'lOfti:	
log	lOɡ	
logical	'lOdZIk@l	
loiter	'lo:It@	
lolly	'lOli:	
lone	l@Un	
lonely	'l@Unli:	
long	lON	
longitude	lONɡ@tSu:d	
look	lUk	
lookout	'lUka:Ut	
loom	lu:m	
loop	lu:p	
loophole	'lu:ph@Ul	
loose	lu:s	
loot	lu:t	
lop	lOp	
lopsided	lOp'sa:Id@d	
lord	lo:d	
lorry	'lOri:	
lose	lu:z	
loss	lOs	
lost	lOst	
lot	lOt	
lotion	'l@US@n	
lottery	'lOt@ri:	
lotto	'lOt@U	
loud	la:Ud	
loudspeaker	la:Ud'spi:k@	
lounge	la:UndZ	
louse	la:Us	
lousy	'la:Uzi:	
lout	la:Ut	
love	lav	
lovely	'lavli:	
low	l@U	
lower	'l@U@	
loyal	'lo:I@l	
lozenge	'lOz@ndZ	
lpg	Elpi:'dZi:	
ltd	'lIm@t@d	
lubricate	'lu:br@kEIt	
lucid	'lu:s@d	
luck	lak	
lucrative	'lu:kr@tIv	
ludicrous	'lu:d@kr@s	
lug	laɡ	
luggage	laɡIdZ	
lukewarm	lu:k'wo:m	
lull	lal	
lullaby	'lal@ba:I	
luminous	'lu:m@n@s	
lump	lamp	
lunar	'lu:n@	
lunatic	'lu:n@tIk	
lunch	lantS	
lung	laN	
lunge	landZ	
lurch	l@:tS	
lurgy	l@:ɡi:	
lurid	'lu:r@d	
lurk	l@:k	
luscious	'laS@s	
lush	laS	
lust	last	
luxuriant	laɡ'Zu:ri:@nt	
luxury	'lakS@ri:	
lying	la:I;IN	
lyrebird	'la:I@b@:d	
m	Em	
macabre	m@'ka:b	
macadamia	mAk@'dEImi:@	
macaroni	mAk@'r@Uni:	
macedonian	mAs@'d@Uni:@n	
machete	m@'SEti:	
machine	m@'Si:n	
machinery	m@'Si:n@ri:	m@'Si:nri:
macho	'mAtS@U	
mad	mAd	
madam	'mAd@m	
made	mEId	
magazine	mAɡ@'zi:n	
maggot	mAɡ@t	
magic	'mAdZIk	
magistrate	'mAdZ@strEIt	
magnanimous	mAɡ'nAn@m@s	
magnate	mAɡnEIt	
magnet	mAɡn@t	
magnificent	mAɡ'nIf@s@nt	
magnify	mAɡn@fa:I	
magnifyingglass	mAɡn@fa:IINɡla:s	
magnitude	mAɡn@tSu:d	
magpie	mAɡpa:I	
maiden	'mEId@n	
mail	mEIl	
mailorder	'mEIlo:d@	
maim	mEIm	
main	mEIn	
mainland	'mEInlAnd	
mainstream	'mEInstri:m	
maintain	mEIn'tEIn	
maitredhotel	mEItr@d@U'tEl	
maize	mEIz	
majesty	'mAdZ@sti:	
major	'mEIdZ@	
majority	m@'dZOr@ti:	
make	mEIk	
make-believe	'mEIk-b@li:v	
make-up	'mEIk-ap	
maladjusted	mAl@'dZast@d	
malaria	m@'lE@ri:@	
male	mEIl	
malevolent	m@'lEv@l@nt	
malformation	mAlfo:'mEIS@n	
malice	'mAl@s	
malign	m@'la:In	
malignant	m@'lIɡn@nt	
malinger	m@'lINɡ@	
mall	mo:l	
malleable	'mAli:@b@l	
mallee	'mAli:	
mallet	'mAl@t	
malnourished	'mAlnarISt	
malpractice	mAl'prAkt@s	
malt	mOlt	
maltreat	mAl'tri:t	
mammal	'mAm@l	
mammoth	'mAm@T	
man	mAn	
manage	'mAnIdZ	
management	'mAnIdZm@nt	
manager	'mAn@dZ@	
manchester	'mAntSEst@	
mandarin	'mAnd@r@n	mAnd@'rIn
mandate	'mAndEIt	
mandatory	'mAnd@tri:	
mane	mEIn	
mange	mEIndZ	
mangle	mANɡ@l	
mangrove	mANɡr@Uv	
mania	'mEIni:@	
maniac	'mEIni:Ak	
manicure	'mAn@kjU@	
manifest	'mAn@fEst	
manifesto	mAn@'fEst@U	
manipulate	m@'nIpj@lEIt	
mankind	mAn'ka:Ind	
manly	'mAnli:	
manner	'mAn@	
mannerism	'mAn@rIz@m	
manoeuvre	m@'nu:v@	
manor	mAn@	
mansion	'mAnS@n	
manslaughter	'mAnslo:t@	
manta	mAnt@	
mantlepiece	'mAnt@lpi:s	
manual	'mAnju:@l	
manufacture	mAnj@'fAktS@	
manure	m@'njU@	
manuscript	'mAnj@skrIpt	
many	'mEni:	
map	mAp	
marathon	'mAr@TOn	
marble	'ma:b@l	
march	ma:tS	
mare	mE@	
margarine	ma:dZ@'ri:n	
margin	'ma:dZ@n	
marginal	'ma:dZ@n@l	
marijuana	mAr@'wa:n@	
marina	m@'ri:n@	
marinate	'mAr@nEIt	
marine	m@'ri:n	
marital	'mAr@t@l	
maritime	'mAr@ta:Im	
mark	ma:k	
mark-up	'ma:k-ap	
market	'ma:k@t	
marketing	'ma:k@tIN	
marmalade	'ma:m@lEId	
maroon	m@'ru:n	
marquee	ma:'ki:	
marriage	'mArIdZ	
married	'mAri:d	
marrow	'mAr@U	
marry	'mAri:	
marsh	ma:S	
marshal	'ma:S@l	
marshmallow	ma:S'mAl@U	
marsupial	ma:'sju:pi:@l	
martyr	'ma:t@	
marvel	'ma:v@l	
mascara	mAs'ka:r@	
mascot	'mAskOt	
masculine	'mAskj@l@n	
mash	mAS	
mask	ma:sk	
mason	'mEIs@n	
masonry	'mEIs@nri:	
masquerade	mAsk@'rEId	
mass	mAs	
massacre	'mAs@k@	
massage	'mAsa:Z	
massive	'mAsIv	
mast	ma:st	
mastectomy	mAs'tEkt@mi:	
master	'ma:st@	
masterpiece	'ma:st@pi:s	
masturbate	'mAst@bEIt	
mat	mAt	
match	mAtS	
mate	mEIt	
material	m@'tI@ri:@l	
materialise	m@'tI@ri:@la:Iz	
materialistic	m@tI@ri:@'lIstIk	
maternal	m@'t@:n@l	
maternity	m@'t@:n@ti:	
mathematics	mAT@'mAtIks	
maths	mATs	
matriarch	'mEItri:a:k	
matrimony	'mAtr@m@ni:	
matt	mAt	
matter	'mAt@	
mattress	'mAtr@s	
mature	m@'tSU@	m@'tSu:@
maul	mo:l	
mauve	m@Uv	
maverick	'mAv@rIk	
maxim	'mAks@m	
maximum	'mAks@m@m	
may	mEI	
maybe	'mEIbi:	
mayonnaise	mEI@'nEIz	
mayor	mE@	
maze	mEIz	
me	mi:	
meagre	mi:ɡ@	
meal	mi:l	
mean	mi:n	
meander	mi:'And@	
means	mi:nz	
meantime	'mi:nta:Im	
meanwhile	'mi:nwa:Il	
measles	'mi:z@lz	
measure	'mEZ@	
meat	mi:t	
mechanic	m@'kAnIk	
mechanical	m@'kAnIk@l	
mechanics	m@'kAnIks	
mechanise	'mEk@na:Iz	
mechanism	'mEk@nIz@m	
medal	'mEd@l	
medallion	m@'dAlj@n	
meddle	'mEd@l	
media	'mi:di:@	
median	'mi:di:@n	
mediate	'mi:di:EIt	
medical	'mEdIk@l	
medicare	'mEdi:kE@	
medicine	'mEd@s@n	
mediocre	mi:di:'@Uk@	
meditate	'mEd@tEIt	
medium	'mi:di:@m	
medley	'mEdli:	
meek	mi:k	
meet	mi:t	
meeting	'mi:tIN	
megabyte	mEɡ@ba:It	
megaphone	mEɡ@f@Un	
melancholy	'mEl@nkOli:	
melanoma	mEl@'n@Um@	
melba	mElb@	
mellow	'mEl@U	
melodrama	'mEl@dra:m@	
melody	'mEl@di:	
melon	'mEl@n	
melt	mElt	
member	'mEmb@	
membrane	'mEmbrEIn	
memento	m@'mEnt@U	
memo	'mEm@U	
memoirs	'mEmwa:z	
memorable	'mEmr@b@l	
memorial	m@'mo:ri:@l	
memorise	'mEm@ra:Iz	
memory	'mEm@ri:	
men	mEn	
menace	'mEn@s	
mend	mEnd	
menial	'mi:ni:@l	
menopause	'mEn@po:z	
menstruate	'mEnstru:EIt	
mental	'mEnt@l	
mention	'mEnS@n	
menu	'mEnju:	
mercenary	'm@:s@nri:	
merchandise	'm@:tS@nda:Is	
mercury	'm@:kj@ri:	
mercy	'm@:si:	
mere	mI@	
merge	m@:dZ	
meringue	m@'rAN	
merino	m@'ri:n@U	
merit	'mEr@t	
mermaid	'm@:mEId	
merry	'mEri:	
merry-go-round	mEri:-ɡ@U-ra:Und	
mesh	mES	
mesmerise	'mEzm@ra:Iz	
mess	mEs	
message	'mEsIdZ	
messenger	'mEs@ndZ@	
metabolism	m@'tAb@lIz@m	
metal	'mEt@l	
metamorphosis	mEt@'mo:f@s@s	
metaphor	'mEt@fo:	
meteor	'mi:ti:o:	
meteorite	'mi:ti:@ra:It	
meteorologist	mi:ti:@'rOl@dZ@st	
meter	'mi:t@	
methadone	'mET@d@Un	
metho	'mET@U	
method	'mET@d	
methodical	m@'TOdIk@l	
methylatedspirits	'mET@lEIt@d'spIr@ts	
meticulous	m@'tIkj@l@s	
metre	'mi:t@	
metric	'mEtrIk	
metropolitan	mEtr@'pOl@t@n	
mezzanine	'mEz@ni:n	
mice	ma:Is	
microbe	'ma:Ikr@Ub	
microphone	'ma:Ikr@f@Un	
microscope	'ma:Ikr@sk@Up	
microwaveoven	ma:Ikr@wEIv'av@n	
mid	mId	
midday	'mIddEI	
middle	'mId@l	
midget	'mIdZ@t	
midnight	'mIdna:It	
midriff	'mIdrIf	
midwife	'mIdwa:If	
might	ma:It	
mighty	'ma:Iti:	
migraine	ma:IɡrEIn	
migrant	ma:Iɡr@nt	
migrate	ma:IɡrEIt	
mild	ma:Ild	
mildew	'mIldju:	
mile	ma:Il	
militant	'mIl@t@nt	
military	'mIl@tri:	
militia	m@'lIS@	
milk	mIlk	
milkbar	'mIlkba:	
milkshake	'mIlkSEIk	
mill	mIl	
millennium	m@'lEni:@m	
millibar	'mIli:ba:	
milligram	mIl@ɡrAm	
millilitre	'mIl@li:t@	
millimetre	'mIl@mi:t@	
milliner	'mIl@n@	
million	'mIlj@n	
mime	ma:Im	
mimic	'mImIk	
mince	mIns	
mincemeat	'mInsmi:t	
mind	ma:Ind	
mindful	'ma:Indf@l	
mindless	'ma:Indl@s	
mine	ma:In	
miner	'ma:In@	
mineral	'mIn@r@l	
mineralwater	'mIn@r@lwo:t@	
mingle	mINɡ@l	
miniature	'mIn@tS@	
minimal	'mIn@m@l	
minimum	'mIn@m@m	
minister	'mIn@st@	
minor	'ma:In@	
minority	ma:I'nOr@ti:	
mint	mInt	
minus	'ma:In@s	
minute	ma:I'nju:t	
miracle	'mIr@k@l	
mirage	m@'ra:Z	
mire	'ma:I@	
mirror	'mIr@	
mirth	m@:T	
misadventure	mIs@d'vEntS@	
misbehave	mIsb@'hEIv	
miscarriage	mIs'kArIdZ	
miscellaneous	mIs@'lEIni:@s	
mischief	'mIstS@f	
misdemeanour	mIsd@'mi:n@	
miser	'ma:Iz@	
miserable	'mIzr@b@l	
misery	'mIz@ri:	
misfortune	mIs'fo:tS@n	
mishap	'mIshAp	
mislay	mIs'lEI	
mislead	mIs'li:d	
miss	mIs	
missile	'mIsa:Il	
missing	'mIsIN	
mission	'mIS@n	
missionary	'mIS@nri:	
mist	mIst	
mistake	m@'stEIk	
mistaken	m@'stEIk@n	
mistress	'mIstr@s	
misunderstand	mIsand@'stAnd	
mitigate	mIt@ɡEIt	
mitten	'mIt@n	
mix	mIks	
mix-up	'mIks-ap	
mixed-up	'mIkst-ap	
mixture	'mIkstS@	
mnemonic	n@'mOnIk	
moan	m@Un	
mob	mOb	
mobile	'm@Uba:Il	
mobilise	'm@Ub@la:Iz	
mock	mOk	
modal	'm@Ud@l	
mode	m@Ud	
model	'mOd@l	
moderate	'mOdr@t	
modern	'mOd@n	
modest	'mOd@st	
modify	'mOd@fa:I	
module	'mOdZu:l	
moist	mo:Ist	
molar	'm@Ul@	
mole	m@Ul	
molecule	'mOl@kju:l	
molest	m@'lEst	
molten	'm@Ult@n	
moment	'm@Um@nt	
momentary	'm@Um@ntri:	
momentous	m@'mEnt@s	
monarch	'mOn@k	'mOna:k
monastery	'mOn@stri:	
monday	'mandEI	
money	'mani:	
mongrel	maNɡr@l	
monitor	'mOn@t@	
monk	maNk	
monkey	'maNki:	
mono	'mOn@U	
monogamy	m@'nOɡ@mi:	
monogram	mOn@ɡrAm	
monolith	'mOn@lIT	
monologue	mOn@lOɡ	
monopoly	m@'nOp@li:	
monosodiumglutamate	mOn@s@Udi:@m'ɡlu:t@mEIt	
monotonous	m@'nOt@n@s	
monotreme	'mOn@tri:m	
monsoon	mOn'su:n	
monster	'mOnst@	
monstrous	'mOnstr@s	
month	manT	
monument	'mOnj@m@nt	
monumental	mOnj@'mEnt@l	
mood	mu:d	
moody	'mu:di:	
moon	mu:n	
moor	mo:	
mooring	'mo:rIN	
mop	mOp	
mope	m@Up	
moral	'mOr@l	
morale	m@'ra:l	
moratorium	mOr@'to:ri:@m	
morbid	'mo:b@d	
more	mo:	
moreover	mo:r'@Uv@	
morgue	mo:ɡ	
mornay	'mo:nEI	
morning	'mo:nIN	
moron	'mo:rOn	
morose	m@'r@Us	
morphine	'mo:fi:n	
morsel	'mo:s@l	
mortal	'mo:t@l	
mortality	mo:'tAl@ti:	
mortar	'mo:t@	
mortgage	mo:ɡIdZ	
mortified	'mo:t@fa:Id	
mortuary	'mo:tS@ri:	
mosaic	m@'zEIIk	m@U'zEIIk
mosque	mOsk	
moss	mOs	
most	m@Ust	
mostly	'm@Ustli:	
motel	m@U'tEl	
mother	'maD@	
mother-in-law	'maD@r-In-lo:	
mother-of-pearl	maD@r-@v-'p@:l	
motif	m@U'ti:f	
motion	'm@US@n	
motivate	'm@Ut@vEIt	
motive	'm@UtIv	
motor	'm@Ut@	
motorbike	'm@Ut@ba:Ik	
motorcycle	'm@Ut@sa:Ik@l	
motorist	'm@Ut@r@st	
mottled	'mOt@ld	
motto	'mOt@U	
mould	m@Uld	
moult	m@Ult	
mound	ma:Und	
mount	ma:Unt	
mountain	'ma:Unt@n	
mountaineer	ma:Unt@'nI@	
mourn	mo:n	
mouse	ma:Us	
mousse	mu:s	
moustache	m@'sta:S	
mousy	'ma:Usi:	
mouth	ma:UT	
mouth-watering	'ma:UT-wo:t@rIN	
move	mu:v	
movement	'mu:vm@nt	
movie	'mu:vi:	
mow	m@U	
mp	Em'pi:	
mr	'mIst@	
mrs	'mIs@z	
ms	Em'Es	
msg	EmEs'dZi:	
much	matS	
muck	mak	
mucus	'mju:k@s	
mud	mad	
muddle	'mad@l	
mudguard	madɡa:d	
muesli	'mju:zli:	
muffin	'maf@n	
muffler	'mafl@	
mug	maɡ	
muggy	maɡi:	
mulch	maltS	
mulga	malɡ@	
mull	mal	
multicultural	malti:'kaltS@r@l	
multimedia	malti:'mi:di:@	
multinational	malti:'nAS@n@l	
multiple	'malt@p@l	
multiplesclerosis	malt@p@lskl@'r@Us@s	
multiple-choice	'malt@p@l-tSo:Is	
multiply	'malt@pla:I	
multiracial	malti:'rEIS@l	
multitude	'malt@tSu:d	
mum	mam	
mumble	'mamb@l	
mummy	'mami:	
mumps	mamps	
munch	mantS	
mundane	man'dEIn	
municipality	mju:n@s@'pAl@ti:	mju:nIs@'pAl@ti:
mural	'mju:r@l	
murder	'm@:d@	
murky	'm@:ki:	
murmur	'm@:m@	
muscle	'mas@l	
museum	mju:'zi:@m	
mush	maS	
mushroom	'maSru:m	
music	'mju:zIk	
musical	'mju:zIk@l	
musk	mask	
must	mast	
mustard	'mast@d	
muster	'mast@	
musty	'masti:	
mutate	mju:'tEIt	
mute	mju:t	
mutilate	'mju:t@lEIt	
mutiny	'mju:t@ni:	
mutter	'mat@	
mutton	'mat@n	
mutual	'mju:tSu:@l	
muzzle	'maz@l	
my	ma:I	
myopia	ma:I'@Upi:@	
myriad	'mIri:@d	
myself	ma:I'sElf	
mysterious	m@s'tI@ri:@s	
mystery	mIstri:	
mystic	'mIstIk	
mystify	'mIst@fa:I	
myth	mIT	
mythology	m@'TOl@dZi:	
n	En	
n/a	En'EI	
nag	nAɡ	
nail	nEIl	
naive	na:I'i:v	
naked	'nEIk@d	
name	nEIm	
nap	nAp	
napkin	'nApk@n	
nappy	'nApi:	
narcotic	na:'kOtIk	
narration	n@'rEIS@n	
narrative	'nAr@tIv	
narrow	'nAr@U	
nasal	'nEIz@l	
nasty	'na:sti:	
nation	'nEIS@n	
national	'nASn@l	
nationalise	'nASn@la:Iz	
nationalism	'nASn@lIz@m	
native	'nEItIv	
natter	'nAt@	
natty	'nAti:	
natural	'nAtS@r@l	
naturalised	'nAtS@r@la:Izd	
nature	'nEItS@	
naughty	'no:ti:	
nausea	'no:zi:@	
navel	'nEIv@l	
navigate	nAv@ɡEIt	
navy	'nEIvi:	
nb	En'bi:	
ne	no:T'i:st	
near	nI@	
nearby	nI@'ba:I	
nearly	'nI@li:	
neat	ni:t	
necessary	'nEs@sEri:	
neck	nEk	
necklace	'nEkl@s	
nee	nEI	'ni:
need	ni:d	
needle	'ni:d@l	
negative	nEɡ@tIv	
neglect	n@'ɡlEkt	
negligee	nEɡl@ZEI	
negligent	nEɡl@dZ@nt	
negligible	nEɡl@dZ@b@l	
negotiable	n@'ɡ@US@b@l	
negotiate	n@'ɡ@USi:;EIt	
neighbour	'nEIb@	
neither	'na:ID@	
nephew	'nEfju:	
nerd	n@:d	
nerve	n@:v	
nervous	'n@:v@s	
nest	nEst	
net	nEt	
netball	'nEtbo:l	
nettle	'nEt@l	
network	'nEtw@:k	
neurotic	nju:'rOtIk	
neuter	'nju:t@	
neutral	'nju:tr@l	
never	'nEv@	
nevertheless	nEv@D@'lEs	
new	nju:	
newington	nju:INt@n	
news	nju:z	
newsagent	'nju:zEIdZ@nt	
newspaper	'nju:zpEIp@	
next	nEkst	
nextofkin	nEkst@v'kIn	
nib	nIb	
nibble	'nIb@l	
nice	na:Is	
niche	ni:S	
nick	nIk	
nickname	'nIknEIm	
nicotine	nIk@'ti:n	
niece	ni:s	
nifty	'nIfti:	
night	na:It	
nightclothes	'na:Itkl@UDz	
nightdress	'na:ItdrEs	
nightmare	'na:ItmE@	
nightshirt	'na:ItS@:t	
nil	nIl	
nimble	'ni:mb@l	
nine	na:In	
nineteen	na:In'ti:n	
nineteenth	na:In'ti:nT	
ninety	'na:Inti:	
ninth	na:InT	
nip	nIp	
nippers	'nIp@z	
nipple	'nIp@l	
nit	nIt	
no	n@U	
no-one	'n@Uwan	
no	'namb@	
noble	'n@Ub@l	
nobody	'n@UbOdi:	
nocturnal	nOk't@:n@l	
nod	nOd	
nodule	'nOdZu:l	
noise	no:Iz	
nominate	'nOm@nEIt	
nonchalant	'nOnS@l@nt	
nondescript	'nOnd@skrIpt	
none	nan	
nonentity	nOn'Ent@ti:	
nonetheless	nanD@'lEs	
nonfiction	nOn'fIkS@n	
nonflammable	nOn'flAm@b@l	
nonplussed	nOn'plast	
nonsense	'nOns@ns	
noodle	nu:d@l	
noon	nu:n	
noose	nu:s	
nor	no:	
normal	'no:m@l	
north	no:T	
northward	'no:Tw@d	
nose	n@Uz	
nostalgia	nOs'tAldZ@	
nostril	'nOstr@l	
not	nOt	
notable	'n@Ut@b@l	
notch	nOtS	
note	n@Ut	
nothing	'naTIN	
notice	'n@Ut@s	
notify	'n@Ut@fa:I	
notion	'n@US@n	
notorious	n@'to:ri:@s	
nought	no:t	
noun	na:Un	
nourish	'narIS	
nov	n@'vEmb@	n@U'vEmb@
novel	'nOv@l	
novelty	'nOv@lti:	
november	n@'vEmb@	n@U'vEmb@
now	na:U	
noxious	'nOkS@s	
nozzle	'nOz@l	
nsw	;nju:sa:UT'wEIlz	
nt	;no:D@n'tEr@tri:	
nuclear	'nju:kli:@	
nucleus	'nju:kli:@s	
nude	'nu:d	
nudge	nadZ	
nugget	naɡ@t	
nuisance	'nju:s@ns	
numb	nam	
number	'nam@	'namb@
numberplate	'namb@plEIt	
numeral	'nju:m@r@l	
numerator	'nju:m@rEIt@	
numerous	'nju:m@r@s	
nun	nan	
nurse	n@:s	
nursery	'n@:s@ri:	'n@:sri:
nut	nat	
nutrition	nju:'trIS@n	
nutritionist	nju:'trIS@ni:st	
nw	no:T'wEst	
nylon	'na:IlOn	
o	@U	
oaf	@Uf	
oaks	@Uks	
oar	o:	
oath	@UT	
obedient	@'bi:di:@nt	
obese	@U'bi:s	
obey	@U'bEI	
object	'ObdZEkt	
objective	@b'dZEktIv	
oblige	@'bla:IdZ	
oblong	'OblON	
obscene	@b'si:n	
obscure	@b'skju:@	
observe	@b'z@:v	
obsession	@b'sES@n	
obsolete	'Obs@li:t	
obstacle	'Obst@k@l	
obstetrician	Obst@'trIS@n	
obstinate	'Obst@n@t	
obstruct	@b'strakt	
obtain	@b'tEIn	
obtuse	@b'tju:s	
obvious	'Obvi:@s	
occasion	@'kEIZ@n	
occasional	@'kEIZ@n@l	
occupation	Okj@'pEIS@n	
occupied	'Okj@pa:Id	
occupy	'Okj@pa:I	
occur	@'k@:	
ocean	'@US@n	
oclock	@'klOk	
october	Ok't@Ub@	
odd	Od	
odious	'@Udi:@s	
odour	'@Ud@	
of	Ov	
off	Of	
off-colour	Of-'kal@	
off-peak	'Of-pi:k	
off-putting	'Of-pUtIN	
offence	@'fEns	
offensive	@'fEnsIv	
offer	'Of@	
office	'Of@s	
officer	'Of@s@	
offices	Of@s@z	
official	@'fIS@l	
often	'Of@n	
oh	@U	
oil	o:Il	
ointment	'o:Intm@nt	
ok	@U'kEI	
okay	@U'kEI	
old	@Uld	
oldage	@Uld'EIdZ	
old-fashioned	@Uld-'fAS@nd	
olive	'Ol@v	'OlIv
olympicgames	@lImpIk'ɡEImz	
ombudsman	'Omb@dzm@n	
omelette	'Oml@t	
omen	'@Um@n	
ominous	'Om@n@s	
omit	@U'mIt	
on	On	
once	wans	
oncoming	'OnkamIN	
one	wan	
only	'@Unli:	
onset	'OnsEt	
onto	'Ont@	'Ontu:
ooze	u:z	
opal	'@Up@l	
opaque	@U'pEIk	
open	'@Up@n	
open-minded	'@Up@n-ma:Ind@d	
opera	'Opr@	
operate	'Op@rEIt	
ophthalmologist	OfTAl'mOl@dZ@st	
opinion	@'pInj@n	
opponent	@'p@Un@nt	
opportunity	Op@'tju:n@ti:	Op@'tSu:n@ti:
oppose	@'p@Uz	
opposite	'Op@s@t	
oppression	@'prES@n	
optician	Op'tIS@n	
optimism	'Opt@mIz@m	
option	'OpS@n	
optometrist	Op'tOm@tr@st	
or	o:	
oral	'Or@l	
orange	OrIndZ	
orator	'Or@t@	
orchard	'o:tS@d	
orchestra	'o:k@str@	
ordeal	o:'di:l	
order	'o:d@	
ordinalnumber	o:d@n@l'namb@	
ordinary	'o:d@nri:	o:d@nEri:
organ	o:ɡ@n	
organic	o:'ɡAnIk	
organisation	o:ɡ@na:I'zEIS@n	
organise	o:ɡ@na:Iz	
organism	o:ɡ@nIz@m	
orgasm	o:ɡAz@m	
orgy	'o:dZi:	
oriental	o:ri:'Ent@l	
origin	'Or@dZ@n	
original	@'rIdZ@n@l	
originate	@'rIdZ@nEIt	
ornament	'o:n@m@nt	
orphan	'o:f@n	
orthodontist	o:T@'dOnt@st	
orthodox	'o:T@dOks	
orthopaedicsurgeon	o:T@;pi:dIk's@:dZ@n	
osteopath	'Osti:@pAT	
other	'aD@	
otherwise	'aD@wa:Iz	
ought	o:t	
our	a:U@	a:U
ours	'a:U@z	a:UZ
ourselves	a:U@'sElvz	a:U'sElvz
out	a:Ut	
outback	'a:UtbAk	
outbreak	'a:UtbrEIk	
outburst	'a:Utb@:st	
outcome	'a:Utkam	
outcry	'a:Utkra:I	
outdoors	a:Ut'do:z	
outer	'a:Ut@	
outfit	'a:UtfIt	
outgoing	a:Ut'ɡ@UIN	
outing	'a:UtIN	
outline	'a:Utla:In	
outlook	'a:UtlUk	
outpatient	'a:UtpEIS@nt	
outrage	a:Ut'rEIdZ	
outright	'a:Utra:It	
outset	'a:UtsEt	
outside	a:Ut'sa:Id	
outskirts	'a:Utsk@:ts	
outspoken	'a:Utsp@Uk@n	
outstanding	a:Ut'stAndIN	
outward	'a:Utw@d	
outwards	'a:Utw@dz	
outwit	a:Ut'wIt	
oval	'@Uv@l	
ovary	'@Uv@ri:	
oven	'av@n	
over	'@Uv@	
overalls	'@Uv@ro:lz	
overarm	'@Uv@ra:m	
overawe	@Uv@r'o:	
overbalance	@Uv@'bAl@ns	
overbearing	@Uv@'bE@rIN	
overboard	'@Uv@bo:d	
overcast	'@Uv@ka:st	
overcoat	'@Uv@k@Ut	
overcome	@Uv@'kam	
overdo	@Uv@'du:	
overdose	'@Uv@d@Us	
overdraft	'@Uv@dra:ft	
overdue	@Uv@'dju:	
overflow	@Uv@'fl@U	
overhaul	'@Uv@ho:l	
overhead	@Uv@'hEd	
overhear	@Uv@'hI@	
overlap	@Uv@'lAp	
overlook	@Uv@'lUk	
overnight	@Uv@'na:It	
overpower	@Uv@'pa:U@	
overrule	@Uv@'ru:l	
overseas	@Uv@'si:z	
oversight	'@Uv@sa:It	
overtake	@Uv@'tEIk	
overtime	'@Uv@ta:Im	
overturn	@Uv@'t@:n	
overweight	@Uv@'wEIt	
overwhelm	@Uv@'wElmd	
overwork	@Uv@'w@:k	
ovulate	'Ovj@lEIt	
owe	@U	
owl	a:Ul	
own	@Un	
oxygen	'Oks@dZ@n	
oyster	'o:Ist@	
p	pi:	
p&c	'pi:@nsi:	pi:@n'si:
p-plate	'pi:-plEIt	
pa	p@:r'An@m	
pm	pi:'Em	
pto	pi:ti:'@U	
pa	pi:'EI	
pace	pEIs	
pacifist	'pAs@f@st	
pacify	'pAs@fa:I	
pack	pAk	
package	'pAkIdZ	
packaging	'pAk@dZIN	
packed	pAkt	
packet	'pAk@t	
pact	pAkt	
pad	pAd	
paddle	'pAd@l	
paddock	'pAd@k	
padlock	'pAdlOk	
paediatrician	pi:di:@'trIS@n	
page	pEIdZ	
paid	pEId	
paid-up	'pEId-ap	
pain	pEIn	
painstaking	'pEInztEIkIN	
paint	pEInt	
painting	'pEIntIN	
pair	pE@	
pal	pAl	
palace	'pAl@s	
palate	'pAl@t	
pale	pEIl	
palm	pa:m	
palpitate	'pAlp@tEIt	
paltry	'po:ltri:	
pamper	'pAmp@	
pamphlet	'pAmfl@t	
pan	pAn	
pancake	'pANkEIk	
pancreas	'pANkri:@s	
pandemonium	pAnd@'m@Uni:@m	
pander	'pAnd@	
pane	pEIn	
panel	'pAn@l	
panelvan	'pAn@lvAn	
pang	pAN	
panic	'pAnIk	
panorama	pAn@'ra:m@	
pant	pAnt	
pantihose	'pAnti:h@Uz	
pantomime	'pAnt@ma:Im	
pantry	'pAntri:	
pants	pAnts	
papsmear	'pApsmI@	
paper	pEIp@	
paperback	'pEIp@bAk	
par	pa:	
parachute	'pAr@Su:t	
parade	p@'rEId	
paradise	'pAr@da:Is	
paradox	'pAr@dOks	
paragraph	pAr@ɡrAf	
parallel	'pAr@lEl	
paralyse	'pAr@la:Iz	
paramedic	pAr@'mEdIk	
paramount	'pAr@ma:Unt	
paranoia	pAr@'no:I@	
paraphernalia	pAr@f@'nEIlj@	
paraphrase	'pAr@frEIz	
paraplegic	pAr@'pli:dZIk	
parasite	'pAr@sa:It	
parcel	'pa:s@l	
pardon	'pa:d@n	
parent	'pE@r@nt	
parish	'pArIS	
park	pa:k	
parka	'pa:k@	
parliament	'pa:l@m@nt	
parody	'pAr@di:	
parole	p@'r@Ul	
parquet	'pa:kEI	
parrot	'pAr@t	
parry	'pAri:	
parsley	'pa:sli:	
part	pa:t	
part-time	pa:t-'ta:Im	
partial	'pa:S@l	
participate	p@'tIs@pEIt	
participle	'pa:t@sIp@l	
particle	'pa:tIk@l	
particular	p@'tIkj@l@	
partition	p@'tIS@n	
partner	'pa:tn@	
party	'pa:ti:	
pass	pa:s	
passage	'pAsIdZ	
passenger	'pAs@ndZ@	
passion	'pAS@n	
passionfruit	'pAS@nfru:t	
passive	'pAsIv	
passport	'pa:spo:t	
password	'pa:sw@:d	
past	pa:st	
pasta	'pAst@	
paste	pEIst	
pastel	'pAst@l	
pasteurise	'pa:stS@ra:Iz	
pastime	'pa:sta:Im	
pastry	'pEIstri:	
pasture	'pa:stS@	
pasty	'pEIsti:	
pat	pAt	
patch	pAtS	
patent	'pEIt@nt	
paternal	p@'t@:n@l	
paternity	p@'t@:n@ti:	
path	pa:T	
pathetic	p@'TEtIk	
pathology	p@'TOl@dZi:	
patient	'pEIS@nt	
patio	'pAti:@U	
patriarch	'pEItri:a:k	
patriot	'pEItri:@t	
patrol	p@'tr@Ul	
patron	'pEItr@n	
patronise	'pAtr@na:Iz	
patter	'pAt@	
pattern	'pAt@n	
pause	po:z	
pave	pEIv	
pavement	'pEIvm@nt	
pavilion	p@'vIlj@n	
pavlova	pAv'l@Uv@	
paw	po:	
pawn	po:n	
pay	pEI	
paye	pi:EIwa:I'i:	
payroll	'pEIr@Ul	
pea	pi:	
peace	pi:s	
peach	pi:tS	
peak	pi:k	
peal	pi:l	
pearl	p@:l	
peasant	'pEz@nt	
peat	pi:t	
pebble	'pEb@l	
peck	pEk	
peckish	'pEkIS	
peculiar	p@'kju:li:@	
pedal	'pEd@l	
pedantic	p@'dAntIk	
peddle	'pEd@l	
pedestal	'pEd@st@l	
pedestrian	p@'dEstri:@n	
pee	pi:	
peek	pi:k	
peel	pi:l	
peep	pi:p	
peer	pI@	
peeve	pi:v	
peevish	'pi:vIS	
peg	pEɡ	
pelt	pElt	
pelvis	'pElv@s	
pen	pEn	
penal	'pi:n@l	
penalise	'pi:n@la:Iz	
penalty	'pEn@lti:	
pencil	'pEns@l	
pendant	'pEnd@nt	
penetrate	'pEn@trEIt	
penfriend	'pEnfrEnd	
penguin	pENɡw@n	
penicillin	pEn@'sIl@n	
peninsula	p@'nInS@l@	
penis	'pi:n@s	
penknife	'pEnna:If	
penny	'pEni:	
pension	'pEnS@n	
pentathlon	pEn'tATlOn	
penthouse	'pEntha:Us	
people	'pi:p@l	
pepper	'pEp@	
peppermint	'pEp@m@nt	
per	p@:	
percent	p@'sEnt	
perceive	p@'si:v	
perception	p@'sEpS@n	
perch	p@:tS	
percolate	'p@:k@lEIt	
perfect	'p@:fEkt	
perform	p@'fo:m	
perfume	'p@:fju:m	
pergola	p@'ɡ@Ul@	
perhaps	p@'hAps	
peril	'pEr@l	
period	'pI@ri:@d	
periodical	pI@ri:'OdIk@l	
peripheral	p@'rIf@r@l	
perish	'pErIS	
perishable	'pErIS@b@l	
perjure	'p@:dZ@	
perk	p@:k	
permanent	'p@:m@n@nt	
permission	p@'mIS@n	
permit	p@'mIt	
perpetrate	'p@:p@trEIt	
perpetual	p@'pEtSu:@l	
persecute	'p@:s@kju:t	
persevere	p@:s@'vI@	
persian	'p@:Z@n	
persist	p@'sIst	
person	'p@:s@n	
personal	'p@:s@n@l	
personality	p@:s@'nAl@ti:	
personify	p@'sOn@fa:I	
personnel	p@:s@'nEl	
perspire	p@'spa:I@	
persuade	p@'swEId	
pert	p@:t	
pertinent	'p@:t@n@nt	
perturb	p@'t@:b	
perverse	p@'v@:s	
pervert	'p@:v@:t	
pessimism	'pEs@mIz@m	
pest	pEst	
pester	'pEst@	
pet	pEt	
petal	'pEt@l	
peterout	pi:t@'a:Ut	
petite	p@'ti:t	
petition	p@'tIS@n	
petrify	'pEtr@fa:I	
petrol	'pEtr@l	
petroleum	p@'tr@Uli:@m	
petticoat	'pEti:k@Ut	
petty	'pEti:	
petulant	'pEtS@l@nt	
pewter	'pju:t@	
phantom	'fAnt@m	
pharmacist	'fa:m@s@st	
phase	fEIz	
phenomenal	f@'nOm@n@l	
phenomenon	f@'nOm@n@n	
phew	fju:	
philosophy	f@'lOs@fi:	
phlegm	flEm	
phlegmatic	flEɡ'mAtIk	
phobia	'f@Ubi:@	
phone	f@Un	
phonetics	f@'nEtIks	
phoney	'f@Uni:	
photo	'f@Ut@U	
photocopy	'f@Ut@U'kOpi:	
photogenic	f@Ut@'dZi:nIk	
photograph	f@Ut@ɡrAf	
phrase	frEIz	
physical	'fIzIk@l	
physician	f@'zIS@n	
physics	'fIzIks	
physiology	fIzi:'Ol@dZi:	
physiotherapist	fIzi:@U'TEr@p@st	
physique	f@'zi:k	
piano	pi:'An@U	
pick	pIk	
picket	'pIk@t	
pickle	'pIk@l	
pickpocket	'pIkpOk@t	
picnic	'pIknIk	
pictorial	pIk'to:ri:@l	
picture	'pIktS@	
pidgin	'pIdZ@n	
pie	pa:I	
piece	pi:s	
pier	pI@	
pierce	pI@s	
pig	pIɡ	
pig-headed	pIɡ-'hEd@d	
pigment	pIɡm@nt	
pigsty	pIɡsta:I	
pile	pa:Il	
pile-up	'pa:Il-ap	
pilfer	'pIlf@	
pilgrim	pIlɡr@m	
pilipino	pIl@'pi:n@U	
pill	pIl	
pillar	'pIl@	
pillow	'pIl@U	
pillowcase	'pIl@UkEIs	
pilot	'pa:Il@t	
pimple	'pImp@l	
pin	pIn	
pin-up	'pIn-ap	
pinch	pIntS	
pine	pa:In	
ping-pong	'pINpON	
pink	pINk	
pioneer	pa:I@'nI@	
pious	'pa:I@s	
pip	pIp	
pipe	pa:Ip	
pirate	'pa:Ir@t	
pistol	'pIst@l	
piston	'pIst@n	
pit	pIt	
pitch	pItS	
pitch-dark	'pItS-da:k	
pitfall	'pItfo:l	
pith	pIT	
pitiful	'pIt@f@l	
pittance	'pIt@ns	
pity	'pIti:	
pivot	'pIv@t	
placate	pl@'kEIt	
place	plEIs	
placid	'plAs@d	
plague	plEIɡ	
plain	plEIn	
plait	plAt	
plan	plAn	
plane	plEIn	
planet	'plAn@t	
plank	plANk	
plant	plAnt	
plaque	pla:k	
plaster	'pla:st@	
plastered	'pla:st@d	
plastic	'plAstIk	
plasticsurgery	plAstIk's@:dZ@ri:	
plate	plEIt	
plateau	'plAt@U	
platform	'plAtfo:m	
platter	'plAt@	
platypus	'plAt@pUs	
plausible	'plo:z@b@l	
play	plEI	
playground	plEIɡra:Und	
playwright	'plEIra:It	
plea	pli:	
plead	pli:d	
pleasant	'plEz@nt	
please	pli:z	
pleasure	'plEZ@	
pleat	pli:t	
pledge	plEdZ	
plenty	'plEnti:	
pliable	'pla:I@b@l	
pliers	'pla:I@z	
plight	pla:It	
plod	plOd	
plonk	plONk	
plot	plOt	
plough	pla:U	
ploy	plo:I	
pluck	plak	
plucky	'plaki:	
plug	plaɡ	
plughole	plaɡh@Ul	
plumber	'plam@	
plummet	'plam@t	
plump	plamp	
plunge	plandZ	
plural	'plU@r@l	
plus	plas	
plush	plaS	
ply	pla:I	
plywood	'pla:IwUd	
pneumonia	nju:'m@Unj@	
po	pi:'@U	
poach	p@UtS	
pocket	'pOk@t	
pocketmoney	'pOk@tmani:	
pod	pOd	
podgy	'pOdZi:	
poem	'p@U@m	
poetry	'p@U@tri:	
point	po:Int	
point-blank	po:Int-'blANk	
pointless	'po:Intl@s	
poise	po:Iz	
poison	'po:Iz@n	
poke	p@Uk	
poker	'p@Uk@	
poky	'p@Uki:	
pole	p@Ul	
police	p@'li:s	
policy	'pOl@si:	
polio	'p@Uli:@U	
polish	'p@UlIS	'pOlIS
polite	p@'la:It	
politician	pOl@'tIS@n	
politics	'pOl@tIks	
poll	pOl	
pollen	'pOl@n	
pollute	p@'lu:t	
polo	'p@Ul@U	
pommy	'pOmi:	
pompous	'pOmp@s	
pond	pOnd	
ponder	'pOnd@	
pong	pON	
pony	'p@Uni:	
ponytail	'p@Uni:tEIl	
poo	pu:	
pooh	pu:	
pool	pu:l	
poor	po:	
pop	pOp	
pope	p@Up	
popular	'pOpj@l@	
populate	'pOpj@lEIt	
porch	po:tS	
pore	po:	
pork	po:k	
pornography	po:'nOɡr@fi:	
porous	'po:r@s	
porridge	'pOrIdZ	
port	po:t	
portable	'po:t@b@l	
porter	'po:t@	
portfolio	po:t'f@Uli:@U	
portion	'po:S@n	
portrait	'po:tr@t	
portray	po:'trEI	
portuguese	po:tS@'ɡi:z	
pose	p@Uz	
posh	pOS	
position	p@'zIS@n	
positive	'pOz@tIv	
possess	p@'zEs	
possession	p@'zES@n	
possessive	p@'zEsIv	
possible	'pOs@b@l	
possum	'pOs@m	
post	p@Ust	
postoffice	p@UstOf@s	
post-mortem	p@Ust-'mo:t@m	
post-officebox	p@Ust-Of@sbOks	
postal-label	'p@Ust@l-lEIb@l	
postbox	'p@UstbOks	
postcard	'p@Ustka:d	
postcode	'p@Ustk@Ud	
poster	'p@Ust@	
posterior	pO'stI@ri:@	
posterity	pO'stEr@ti:	
postgraduate	p@Ust'ɡrAdZu:@t	
postman	'p@Ustm@n	
postpone	p@Ust'p@Un	
postscript	'p@UstskrIpt	
posture	'pOstS@	
posy	'p@Uzi:	
pot	pOt	
potato	p@'tEIt@U	
potent	'p@Ut@nt	
potential	p@'tEnS@l	
pothole	'pOth@Ul	
potter	'pOt@	
potty	'pOti:	
pouch	pa:UtS	
poultry	'p@Ultri:	
pounce	pa:Uns	
pound	pa:Und	
pour	po:	
pout	pa:Ut	
poverty	'pOv@ti:	
powder	'pa:Ud@	
power	'pa:U@	
practical	'prAktIk@l	
practically	'prAktIkli:	
practice	'prAkt@s	
practise	'prAkt@s	
praise	prEIz	
pram	prAm	
prance	prAns	
prank	'prANk	
prattle	'prAt@l	
prawn	pro:n	
pray	prEI	
preach	pri:tS	
precarious	pr@'kE@ri:@s	
precaution	pr@'ko:S@n	
precede	pri:'si:d	pr@'si:d
precedent	'pri:s@d@nt	
precious	'prES@s	
precipice	'prEs@p@s	
precis	'prEIsi:	
precise	pr@'sa:Is	
precocious	pr@'k@US@s	
predecessor	'pri:d@sEs@	
predicament	pr@'dIk@m@nt	
predict	pr@'dIkt	
predictable	pr@'dIkt@b@l	
predominant	pr@'dOm@n@nt	
preen	pri:n	
preface	'prEf@s	
prefect	'pri:fEkt	
prefer	pr@'f@:	
prefix	'pri:fIks	
pregnant	prEɡn@nt	
prejudice	'prEdZ@d@s	
preliminary	pr@'lIm@nri:	
prelude	'prElju:d	
premature	'prEm@tS@	prEm@'tSU@
premier	'prEmi:@	
premiere	prEmi:'E@	
premise	'prEm@s	
premium	'pri:mi:@m	
premonition	'prEm@nIS@n	
preoccupied	pri:'Okj@pa:Id	
prepare	pr@'pE@	
preposition	prEp@'zIS@n	
preposterous	pr@'pOstr@s	
prescribe	pr@'skra:Ib	
prescription	pr@'skrIpS@n	
present	'prEz@nt	
presentable	pr@'zEnt@b@l	
presently	'prEz@ntli:	
preserve	pr@'z@:v	
president	'prEz@d@nt	
press	prEs	
press-up	'prEs-ap	
pressure	'prES@	
prestige	prEs'ti:Z	
presume	pr@'zju:m	
pretend	pr@'tEnd	
pretty	'prIti:	
prevalent	'prEv@l@nt	
prevaricate	pr@'vAr@kEIt	
prevent	pr@'vEnt	
preview	'pri:vju:	
previous	'pri:vi:@s	
prey	prEI	
price	pra:Is	
priceless	'pra:Isl@s	
pricey	'pra:Isi:	
prick	prIk	
pride	pra:Id	
priest	pri:st	
prig	prIɡ	
prim	prIm	
primary	'pra:Im@ri:	
primaryschool	'pra:Imri:sku:l	
prime	pra:Im	
primeminister	pra:Im'mIn@st@	
primenumber	pra:Im'namb@	
primitive	'prIm@tIv	
prince	prIns	
princess	'prInsEs	
principal	'prIns@p@l	
principle	'prIns@p@l	
print	prInt	
printer	'prInt@	
prior	'pra:I@	
priority	pra:I'Or@ti:	
prise	pra:Iz	
prism	'prIz@m	
prison	'prIz@n	
private	'pra:Iv@t	
privilege	'prIv@lIdZ	
prize	pra:Iz	
prorata	pr@U'ra:t@	
probable	'prOb@b@l	
probe	pr@Ub	
problem	'prObl@m	
procedure	pr@'si:dZ@	
proceed	pr@'si:d	
process	'pr@UsEs	
prod	prOd	
prodigy	'prOd@dZi:	
produce	pr@'dju:s	'prOdZu:s
product	'prOdakt	
productive	pr@'daktIv	
profession	pr@'fES@n	
professor	pr@'fEs@	
proficient	pr@'fIS@nt	
profile	'pr@Ufa:Il	
profit	'prOf@t	
profound	pr@'fa:Und	
program	pr@UɡrAm	
programme	pr@UɡrAm	
progress	pr@UɡrEs	
progressive	pr@'ɡrEsIv	
prohibit	pr@'hIb@t	
project	'pr@UdZEkt	
prologue	pr@UlOɡ	
prolong	pr@'lON	
promenade	prOm@'na:d	
prominent	'prOm@n@nt	
promise	'prOm@s	
promote	pr@'m@Ut	
prompt	prOmpt	
prone	pr@Un	
prong	prON	
pronoun	'pr@Una:Un	
pronounce	pr@'na:Uns	
pronounced	pr@'na:Unst	
proof	pru:f	
prop	prOp	
propaganda	prOp@'ɡAnd@	
propel	pr@'pEl	
proper	'prOp@	
property	'prOp@ti:	
proportion	pr@'po:S@n	
propose	pr@'p@Uz	
proprietarylimitedcompany	pr@'pra:I@tri:lIm@t@d'kamp@ni:	
proprietor	pr@'pra:I@t@	
prose	pr@Uz	
prosecute	'prOs@kju:t	
prospect	'prOspEkt	
prospectus	pr@'spEkt@s	
prosper	'prOsp@	
prostitute	'prOst@tju:t	
protect	pr@'tEkt	
protective	pr@'tEktIv	
protein	'pr@Uti:n	
protest	pr@'tEst	
protestant	'prOt@st@nt	
protocol	'pr@Ut@kOl	
prototype	'pr@Ut@ta:Ip	'pr@Ut@Uta:Ip
protracted	pr@'trAkt@d	
proud	pra:Ud	
prove	pru:v	
provide	pr@'va:Id	
provision	pr@'vIZ@n	
provisional	pr@'vIZ@n@l	
provoke	pr@'v@Uk	
prowl	pra:Ul	
proxy	'prOksi:	
prudent	'pru:d@nt	
prune	pru:n	
pry	pra:I	
ps	pi:'Es	
pseudonym	'sju:d@nIm	
psych	sa:Ik	
psyche	'sa:Iki:	
psychiatrist	s@'ka:I@tr@st	
psychic	'sa:IkIk	
psycho	'sa:Ik@U	
psychoanalyst	sa:Ik@U'An@l@st	
psychology	sa:I'kOl@dZi:	
pub	pab	
puberty	'pju:b@ti:	
pubic	'pju:bIk	
public	'pablIk	
publicrelations	pablIkr@'lEIS@nz	
publicschool	pablIk'sku:l	
publicservant	pablIk's@:v@nt	
publicservice	pablIk's@:v@s	
publican	'pablIk@n	
publication	pabl@'kEIS@n	
publicity	pab'lIs@ti:	
publish	'pablIS	
pucker	'pak@	
pudding	'pUdIN	
puddle	'pad@l	
puff	paf	
pugnacious	paɡ'nEIS@s	
pull	pUl	
pullover	'pUl@Uv@	
pulp	palp	
pulse	pals	
pump	pamp	
pumpkin	'pampk@n	
pun	pan	
punch	pantS	
punctual	'paNktSu:@l	
punctuation	paNktSu:'EIS@n	
puncture	'paNktS@	
punish	'panIS	
punt	pant	
puny	'pju:ni:	
pup	pap	
pupil	'pju:p@l	
puppet	'pap@t	
purchase	'p@:tS@s	
pure	'pju:@	
puree	'pju:rEI	
purge	p@:dZ	
purple	p@:p@l	
purpose	'p@:p@s	
purr	p@:	
purse	p@:s	
pursue	p@'sju:	
pus	pas	
push	pUS	
push-up	'pUS-ap	
pushed	pUSt	
pusher	'pUS@	
pushover	'pUS@Uv@	
put	pUt	
putty	'pati:	
puzzle	'paz@l	
pyjamas	p@'dZa:m@z	
pylon	'pa:IlOn	
pyramid	'pIr@mId	
python	'pa:IT@n	
q	kju:	
qc	kju:'si:	
qld	'kwi:nzl@nd	kwi:nzlAnd
quack	kwAk	
quadrangle	kwOdrANɡ@l	
quadriplegic	kwOdr@'pli:dZIk	
quadruped	'kwOdr@pEd	
quadruple	kwOd'ru:p@l	
quadruplet	kwO'dru:pl@t	
quaint	kwEInt	
quake	kwEIk	
qualify	'kwOl@fa:I	
quality	'kwOl@ti:	
quantity	'kwOnt@ti:	
quarantine	'kwOr@nti:n	
quarrel	'kwOr@l	
quarry	'kwOri:	
quarter	'kwo:t@	
quartet	kwo:'tEt	
quay	ki:	
queen	kwi:n	
queer	'kwI@	
query	'kwI@ri:	
quest	kwEst	
question	'kwEstS@n	
questionnaire	kwEstS@n'E@	
queue	kju:	
quibble	'kwIb@l	
quiche	ki:S	
quick	kwIk	
quicksand	'kwIksAnd	
quiet	'kwa:I@t	
quilt	kwIlt	
quinine	'kwIni:n	
quip	kwIp	
quit	kwIt	
quite	kwa:It	
quiz	kwIz	
quorum	'kwo:r@m	
quota	'kw@Ut@	
quotation	kw@U'tEIS@n	
quotationmarks	kw@U'tEIS@nma:ks	
quote	kw@Ut	
r	a:	
rabbi	'rAba:I	
rabble	'rAb@l	
race	rEIs	
racecourse	'rEIsko:s	
racist	'rEIs@st	
rack	rAk	
racket	'rAk@t	
racquet	'rAk@t	
radar	'rEIda:	
radiation	rEIdi:'EIS@n	
radiator	'rEIdi:EIt@	
radical	'rAdIk@l	
radio	'rEIdi:@U	
radioactive	rEIdi:@U'AktIv	
radiography	rEIdi:'Oɡr@fi:	
radiologist	rEIdi:'Ol@dZ@st	
radiotherapy	rEIdi:@U'TEr@pi:	
radish	'rAdIS	
radius	'rEIdi:@s	
raffle	'rAf@l	
rafter	'ra:ft@	
rag	rAɡ	
rage	rEIdZ	
ragged	rAɡ@d	
raid	rEId	
rail	rEIl	
railing	'rEIlIN	
railway	rEIlwEI	
rain	rEIn	
rainbow	'rEInb@U	
rainforest	'rEInfOr@st	
raise	rEIz	
raisin	'rEIz@n	
rake	rEIk	
rally	'rAli:	
ram	rAm	
ramble	'rAmb@l	
ramp	rAmp	
ramshackle	'rAmSAk@l	
ran	rAn	
random	'rAnd@m	
rang	rAN	
range	rEIndZ	
ranger	'rEIndZ@	
rank	rANk	
ransack	'rAnsAk	
ransom	'rAns@m	
rape	rEIp	
rapid	'rAp@d	
rare	rE@	
rash	rAS	
rasher	'rAS@	
rat	rAt	
rate	rEIt	
rather	'ra:D@	
ratio	'rEISi:@U	
ration	'rAS@n	
ratshit	'rAtSIt	
rattle	'rAt@l	
rave	rEIv	
ravenous	'rAv@n@s	
ravine	r@'vi:n	
ravishing	'rAv@SIN	
raw	ro:	
ray	rEI	
razor	'rEIz@	
re	ri:	
re-count	'ri:-ka:Unt	
reach	ri:tS	
react	ri:'Akt	
read	ri:d	
ready	'rEdi:	
real	ri:l	
realestate	'ri:l@stEIt	
realise	'ri:@la:Iz	
realist	'ri:@l@st	
reality	ri:'Al@ti:	
really	'rI@li:	
realty	'ri:@lti:	
rear	'rI@	
reason	'ri:z@n	
reasonable	'ri:z@n@b@l	
rebate	'ri:bEIt	
rebel	'rEb@l	
recall	'r@ko:l	
recede	r@'si:d	
receipt	r@'si:t	
receive	r@'si:v	
receiver	r@'si:v@	
recent	'ri:s@nt	
receptacle	r@'sEpt@k@l	
reception	r@'sEpS@n	
receptionist	r@'sEpS@n@st	
recess	r@'sEs	
recession	r@'sES@n	
recipe	'rEs@pi:	
recipient	r@'sIpi:@nt	
recital	r@'sa:It@l	
recite	r@'sa:It	
reckless	'rEkl@s	
reckon	'rEk@n	
recognise	rEk@ɡna:Iz	
recoil	r@'ko:Il	
recollect	rEk@'lEkt	
recommend	rEk@'mEnd	
reconcile	'rEk@nsa:Il	
record	r@'ko:d	
record-player	'rEko:d-plEI@	
recorder	r@'ko:d@	
recount	r@'ka:Unt	
recover	r@'kav@	
recreation	rEkri:'EIS@n	
recruit	r@'kru:t	
rectangle	rEktANɡ@l	
rectum	'rEkt@m	
recuperate	r@'ku:p@rEIt	
recur	r@'k@:	
recycle	ri:'sa:Ik@l	
red	rEd	
redtape	rEd'tEIp	
red-back	'rEd-bAk	
redeem	r@'di:m	
reduce	r@'dju:s	
redundant	r@'dand@nt	
reef	ri:f	
reel	ri:l	
refer	r@'f@:	
referee	rEf@'ri:	
reference	'rEfr@ns	
referendum	rEf@'rEnd@m	
reflect	r@'flEkt	
reflex	'ri:flEks	
reflexivepronoun	r@flEksIv'pr@Una:Un	
reform	r@'fo:m	
refrain	r@'frEIn	
refresh	r@'frES	
refreshments	r@'frESm@nts	
refrigerator	r@'frIdZ@rEIt@	
refuge	'rEfju:dZ	
refugee	rEfju:'dZi:	
refund	'ri:fand	
refuse	r@'fju:z	
regain	r@'ɡEIn	
regard	r@'ɡa:d	
regardless	r@'ɡa:dl@s	
regime	rEI'Zi:m	
region	'ri:dZ@n	
register	'rEdZ@st@	
registry	'rEdZ@stri:	
registryoffice	'rEdZ@stri:Of@s	
rego	'rEdZ@U	
regret	r@'ɡrEt	
regular	rEɡj@l@	
regulate	rEɡj@lEIt	
regulation	rEɡj@'lEIS@n	
rehabilitate	ri:h@'bIl@tEIt	
rehearse	r@'h@:s	
reign	rEIn	
reimburse	ri:Im'b@:s	
rein	rEIn	
reincarnation	ri:Inka:'nEIS@n	
reinforce	ri:In'fo:s	
reinforcements	ri:In'fo:sm@nts	
reinstate	ri:In'stEIt	
reject	r@'dZEkt	
rejoice	r@'dZo:Is	
relapse	r@'lAps	
relate	r@'lEIt	
relation	r@'lEIS@n	
relationship	r@'lEIS@nSIp	
relative	'rEl@tIv	
relativepronoun	rEl@tIv'pr@Una:Un	
relatively	'rEl@tIvli:	
relax	r@'lAks	
relay	'ri:lEI	
release	r@'li:s	
relent	r@'lEnt	
relentless	r@'lEntl@s	
relevant	'rEl@v@nt	
reliable	r@'la:I@b@l	
reliant	r@'la:I@nt	
relic	'rElIk	
relief	r@'li:f	
relieve	r@'li:v	
religion	r@'lIdZ@n	
reluctant	r@'lakt@nt	
rely	r@'la:I	
remain	r@'mEIn	
remainder	r@'mEInd@	
remark	r@'ma:k	
remarkable	r@'ma:k@b@l	
remarry	ri:'mAri:	
remedy	'rEm@di:	
remember	r@'mEmb@	
remind	r@'ma:Ind	
remittance	r@'mIt@ns	
remnant	'rEmn@nt	
remote	r@'m@Ut	
removalist	r@'mu:v@l@st	
remove	r@'mu:v	
renal	'ri:n@l	
renew	r@'nju:	
renounce	r@'na:Uns	
renovate	'rEn@vEIt	
rent	rEnt	
rental	'rEnt@l	
repair	r@'pE@	
repay	ri:'pEI	
repayment	r@'pEIm@nt	
repeat	r@'pi:t	
repeated	r@'pi:t@d	
repel	r@'pEl	
repellent	r@'pEl@nt	
repent	r@'pEnt	
replace	r@'plEIs	
replay	'ri:plEI	
replica	'rEplIk@	
reply	r@'pla:I	
report	r@'po:t	
reporter	r@'po:t@	
repossess	ri:p@'zEs	
represent	rEpr@'zEnt	
representative	rEpr@'zEnt@tIv	
reprieve	r@'pri:v	
reprimand	'rEpr@ma:nd	
reprint	ri:'prInt	
reproach	r@'pr@UtS	
reproduce	ri:pr@'dju:s	
reptile	'rEpta:Il	
republic	r@'pablIk	
repugnant	r@'paɡn@nt	
repulsive	r@'palsIv	
reputable	'rEpj@t@b@l	
reputation	rEpj@'tEIS@n	
reputed	r@'pju:t@d	
request	r@'kwEst	
require	r@'kwa:I@	
rescue	'rEskju:	
research	r@'s@:tS	
resemble	r@'zEmb@l	
resent	r@'zEnt	
reservation	rEz@'vEIS@n	
reserve	r@'z@:v	
reserveprice	r@z@:v'pra:Is	
reserved	r@'z@:vd	
reservoir	'rEz@vwa:	
residence	'rEz@d@ns	
resident	'rEz@d@nt	
residential	rEz@'dEnS@l	
residue	'rEz@dju:	
resign	r@'za:In	
resist	r@'zIst	
resistant	r@'zIst@nt	
resolute	'rEz@lu:t	
resolution	rEz@'lu:S@n	
resolve	r@'zOlv	
resort	r@'zo:t	
resource	r@'zo:s	
resourceful	r@'zo:sfUl	
respect	r@'spEkt	
respectable	r@'spEkt@b@l	
respectively	r@'spEktIvli:	
respiration	rEsp@'rEIS@n	
respond	r@'spOnd	
responsible	r@'spOns@b@l	
rest	rEst	
restaurant	'rEst@rOnt	
restless	'rEstl@s	
restore	r@'sto:	
restrain	r@'strEIn	
restrained	r@'strEInd	
restrict	r@'strIkt	
result	r@'zalt	
resum;aae	'rEZju:mEI	
resume	r@'zju:m	
resurrect	rEz@'rEkt	
resuscitate	r@'sas@tEIt	
retail	'ri:tEIl	
retain	r@'tEIn	
retaliate	r@'tAli:EIt	
retire	r@'ta:I@	
retrace	ri:'trEIs	
retreat	r@'tri:t	
retrench	r@'trEntS	
retrieve	r@'tri:v	
retrospective	rEtr@'spEktIv	
return	r@'t@:n	
reunion	ri:'ju:nj@n	
reveal	r@'vi:l	
revel	'rEv@l	
revenge	r@'vEndZ	
revenue	'rEv@nju:	
reverend	'rEvr@nd	
reverent	'rEvr@nt	
reverse	r@'v@:s	
revert	r@'v@:t	
review	r@'vju:	
revise	r@'va:Iz	
revive	r@'va:Iv	
revolt	r@'v@Ult	
revolution	rEv@'lu:S@n	
revolutionary	rEv@'lu:S@nri:	
revolve	r@'vOlv	
revolver	r@'vOlv@	
reward	r@'wo:d	
rewarding	r@'wo:dIN	
rheumatism	'ru:m@tIz@m	
rhyme	ra:Im	
rhythm	'rID@m	
rib	rIb	
ribbon	'rIb@n	
rice	ra:Is	
rich	rItS	
rid	rId	
riddle	'rId@l	
ride	ra:Id	
ridge	rIdZ	
ridicule	'rId@kju:l	
ridiculous	r@'dIkj@l@s	
rifle	'ra:If@l	
rift	rIft	
rig	rIɡ	
right	ra:It	
rightful	'ra:Itf@l	
rigid	'rIdZ@d	
rim	rIm	
rind	ra:Ind	
ring	rIN	
ring-in	'rIN-In	
ringworm	'rINw@:m	
rinse	rIns	
riot	'ra:I@t	
rip	rIp	
ripcord	'rIpko:d	
ripe	ra:Ip	
ripple	'rIp@l	
rise	ra:Iz	
risk	rIsk	
rival	'ra:Iv@l	
river	'rIv@	
road	r@Ud	
roadway	'r@UdwEI	
roadworks	'r@Udw@:ks	
roam	r@Um	
roar	ro:	
roast	r@Ust	
rob	rOb	
robbery	'rOb@ri:	
robe	r@Ub	
robot	'r@UbOt	
robust	'r@Ubast	
rock	rOk	
rockery	'rOk@ri:	
rocket	'rOk@t	
rod	rOd	
rode	r@Ud	
rogue	r@Uɡ	
role	r@Ul	
roll	r@Ul	
roller-skate	'r@Ul@-skEIt	
rom	rOm	
roman	'r@Um@n	
romance	r@'mAns	'r@UmAns
romanian	r@U'mEIni:@n	
romp	rOmp	
roof	ru:f	
room	ru:m	
rooms	ru:mz	
rooster	'ru:st@	
root	ru:t	
rope	r@Up	
ropeable	'r@Up@b@l	
rort	ro:t	
rose	r@Uz	
roster	'rOst@	
rosy	'r@Uzi:	
rot	rOt	
rotate	r@U'tEIt	
rotten	'rOt@n	
rough	raf	
roughage	'rafIdZ	
roulette	ru:'lEt	
round	ra:Und	
roundabout	'ra:Und@ba:Ut	
rouse	ra:Uz	
route	ru:t	
routine	ru:'ti:n	
row	r@U	
rowdy	'ra:Udi:	
royal	'ro:I@l	
royalty	'ro:I@lti:	
rsl	a:rEs'El	
rsvp	a:rEsvi:'pi:	
rub	rab	
rubber	'rab@	
rubbish	'rabIS	
rubble	'rab@l	
rubella	ru:'bEl@	
ruby	'ru:bi:	
rucksack	'raksAk	
rudder	'rad@	
ruddy	'radi:	
rude	ru:d	
ruffian	'rafi:@n	
rug	raɡ	
rugby	raɡbi:	
rugged	raɡ@d	
ruin	'ru:@n	
rule	ru:l	
ruler	'ru:l@	
rum	ram	
rumble	'ramb@l	
rummage	'ramIdZ	
rumour	'ru:m@	
rump	ramp	
rumple	'ramp@l	
rumpus	'ramp@s	
run	ran	
run-down	ran-'da:Un	
rung	raN	
runner-up	ran@r-'ap	
runny	'rani:	
runt	rant	
runway	'ranwEI	
rupture	'raptS@	
rural	'ru:r@l	
rush	raS	
rust	rast	
rut	rat	
ruthless	'ru:Tl@s	
s	Es	
sa	sa:UT@'strEIlj@	
sabbath	'sAb@T	
sabinvaccine	'sEIb@nvAksi:n	sEIb@nvAk'si:n
sabotage	'sAb@ta:Z	
saccharin	'sAk@r@n	
sachet	'sASEI	
sack	sAk	
sacrament	'sAkr@m@nt	
sacred	'sEIkr@d	
sacrifice	'sAkr@fa:Is	
sacrilege	'sAkr@lIdZ	
sad	sAd	
saddle	'sAd@l	
safari	s@'fa:ri:	
safe	sEIf	
sag	sAɡ	
saga	sa:ɡ@	
sage	sEIdZ	
said	sEd	
sail	sEIl	
sailor	'sEIl@	
saint	sEInt	
sake	sEIk	
salad	'sAl@d	
salami	s@'la:mi:	
salary	'sAl@ri:	
sale	sEIl	
salestax	'sEIlztAks	
salesperson	'sEIlzp@:s@n	
saline	'sEIla:In	
saliva	s@'la:Iv@	
sallow	'sAl@U	
salon	'sAlOn	
saloon	s@'lu:n	
salt	sOlt	
salute	s@'lu:t	
salvage	'sAlvIdZ	
salvation	sAl'vEIS@n	
same	sEIm	
sample	'sAmp@l	
sanatorium	sAn@'to:ri:@m	
sanction	'sANkS@n	
sand	sAnd	
sandal	'sAnd@l	
sandpaper	'sAndpEIp@	
sandwich	'sAnwItS	
sandy	sAndi:	
sane	sEIn	
sang	sAN	
sanitary	sAn@tri:	
sank	sANk	
sap	sAp	
sapphire	'sAfa:I@	
sarcasm	'sa:kAz@m	
sardine	sa:'di:n	
sari	'sa:ri:	
sarong	s@'rON	
sash	sAS	
sat	sAt	
satchel	'sAtS@l	
satellite	'sAt@la:It	
satin	'sAt@n	
satire	'sAta:I@	
satisfactory	sAt@s'fAktri:	
satisfy	'sAt@sfa:I	
saturate	'sAtS@rEIt	
saturday	'sAt@dEI	
sauce	so:s	
saucepan	'so:sp@n	
saucer	'so:s@	
sauna	'so:n@	
saunter	'so:nt@	
sausage	'sOsIdZ	
saute	's@UtEI	'so:tEI
savage	'sAvIdZ	
save	sEIv	
saviour	'sEIvj@	
savour	'sEIv@	
savoury	'sEIv@ri:	
saw	so:	
say	sEI	
scab	skAb	
scaffold	'skAf@Uld	
scaffolding	'skAf@ldIN	
scald	sko:ld	
scale	skEIl	
scallop	'skOl@p	
scalp	skAlp	
scalpel	'skAlp@l	
scam	skAm	
scamp	skAmp	
scamper	'skAmp@	
scan	skAn	
scandal	'skAnd@l	
scandinavian	skAnd@'nEIvi:@n	
scant	skAnt	
scapegoat	skEIpɡ@Ut	
scar	ska:	
scarce	skE@s	
scarcely	'skE@sli:	
scare	skE@	
scarecrow	'skE@kr@U	
scared	skE@d	
scarf	ska:f	
scarlet	'ska:l@t	
scarletfever	ska:l@t'fi:v@	
scary	'skE@ri:	
scathing	'skEIDIN	
scatter	'skAt@	
scatterbrain	'skAt@brEIn	
scatty	'skAti:	
scavenge	'skAv@ndZ	
scene	si:n	
scenery	'si:n@ri:	
scent	sEnt	
sceptical	'skEptIk@l	
schedule	'SEdZu:l	
scheme	ski:m	
scholar	'skOl@	
scholarship	'skOl@SIp	
school	sku:l	
schooner	'sku:n@	
science	'sa:I@ns	
scientist	'sa:I@nt@st	
scissors	'sIz@z	
scoff	skOf	
scold	sk@Uld	
scone	skOn	
scoop	sku:p	
scooter	'sku:t@	
scope	sk@Up	
scorch	sko:tS	
score	sko:	
scorn	sko:n	
scot-free	skOt-'fri:	
scotch	skOtS	
scottish	'skOtIS	
scoundrel	'ska:Undr@l	
scout	ska:Ut	
scowl	ska:Ul	
scrabble	'skrAb@l	
scraggy	skrAɡi:	
scramble	'skrAmb@l	
scrap	skrAp	
scrape	skrEIp	
scratch	skrAtS	
scrawl	skro:l	
scream	skri:m	
screech	skri:tS	
screen	skri:n	
screw	skru:	
screwdriver	'skru:dra:Iv@	
scribble	'skrIb@l	
scrimp	skrImp	
script	skrIpt	
scripture	'skrIptS@	
scroll	skr@Ul	
scrotum	'skr@Ut@m	
scrounge	skra:UndZ	
scrub	skrab	
scruff	skraf	
scruffy	'skrafi:	
scrum	skram	
scrupulous	'skru:pj@l@s	
scrutinise	'skru:t@na:Iz	
scubadiving	'sku:b@da:IvIN	
scuff	skaf	
scuffle	'skaf@l	
scullery	'skal@ri:	
sculpture	'skalptS@	
scum	skam	
scurry	'skari:	
scuttle	'skat@l	
sea	si:	
seafood	'si:fu:d	
seagull	si:ɡal	
seal	si:l	
seam	si:m	
seance	'sEIOns	
search	s@:tS	
seashore	'si:So:	
seasickness	'si:sIkn@s	
seaside	'si:sa:Id	
season	'si:z@n	
seasonal	'si:z@n@l	
seat	si:t	
sec	sEk	
secateurs	'sEk@t@z	
second	'sEk@nd	
second-class	'sEk@nd-kla:s	
second-hand	sEk@nd-'hAnd	
second-rate	'sEk@nd-rEIt	
secondary	'sEk@ndri:	
secret	'si:kr@t	
secretary	'sEkr@tri:	
secrete	s@'kri:t	
sect	sEkt	
section	'sEkS@n	
sector	'sEkt@	
secular	'sEkj@l@	
secure	s@'kju:@	
security	s@'kju:r@ti:	
sedan	s@'dAn	
sedate	s@'dEIt	
sedative	'sEd@tIv	
sediment	'sEd@m@nt	
seduce	s@'dju:s	
see	si:	
seed	si:d	
seedling	'si:dlIN	
seedy	'si:di:	
seek	si:k	
seem	si:m	
seep	si:p	
seesaw	'si:so:	
segment	sEɡm@nt	
segregate	sEɡr@ɡEIt	
seize	si:z	
seldom	'sEld@m	
select	s@'lEkt	
selective	s@'lEktIv	
self	sElf	
self-centred	sElf-'sEnt@d	
self-confident	sElf-'kOnf@d@ns	
self-conscious	sElf-'kOnS@s	
self-defence	sElf-d@'fEns	
self-service	sElf-'s@:v@s	
selfish	'sElfIS	
sell	sEl	
semen	'si:m@n	
semester	s@'mEst@	
semi-conscious	sEmi:-'kOnS@s	
semi-detached	sEmi:d@'tAtSt	
semicolon	sEmi:'k@Ul@n	
seminar	'sEm@na:	
seminary	'sEm@nri:	
semitrailer	sEmi:'trEIl@	
senate	'sEn@t	
senator	'sEn@t@	
send	sEnd	
senile	'sEna:Il	
senior	'si:nj@	
sensation	sEn'sEIS@n	
sensational	sEn'sEIS@n@l	
sense	sEns	
sensible	'sEns@b@l	
sensitive	'sEns@tIv	
sent	sEnt	
sentence	'sEnt@ns	
sentiment	'sEnt@m@nt	
sentimental	sEnt@'mEnt@l	
sentry	'sEntri:	
separate	'sEpr@t	
sept	s@p'tEmb@	
september	s@p'tEmb@	
septic	'sEptIk	
septictank	sEptIk'tANk	
sequel	'si:kw@l	
sequence	'si:kw@ns	
serbian	's@:bi:@n	
serene	s@'ri:n	
sergeant	'sa:dZ@nt	
serial	'sI@ri:@l	
series	'sI@ri:z	
serious	'sI@ri:@s	
sermon	's@:m@n	
serpent	's@:p@nt	
serrated	s@'rEIt@d	
serum	'sI@r@m	
servant	's@:v@nt	
serve	s@:v	
service	's@:v@s	
servicestation	's@:v@sstEIS@n	
serviceable	's@:v@s@b@l	
serviette	s@:vi:'Et	
serving	's@:vIN	
servingspoon	's@:vINspu:n	
session	'sES@n	
set	sEt	
set-up	'sEt-ap	
setback	'sEtbAk	
settee	sE'ti:	
setting	'sEtIN	
settle	'sEt@l	
seven	'sEv@n	
seventeen	sEv@n'ti:n	
seventeenth	sEv@n'ti:nT	
seventh	'sEv@nT	
seventies	'sEv@nti:z	
seventy	'sEv@nti:	
sever	'sEv@	
several	'sEvr@l	
severancepay	'sEvr@nspEI	
severe	s@'vI@	
sew	s@U	
sewage	'su:IdZ	
sewer	'su:@	
sewerage	'su:@rIdZ	
sewingmachine	's@UINm@Si:n	
sex	sEks	
sexism	'sEksIz@m	
sexy	'sEksi:	
shabby	'SAbi:	
shack	SAk	
shade	SEId	
shadow	'SAd@U	
shaggy	SAɡi:	
shake	SEIk	
shake-up	'SEIkap	
shall	SAl	
shallow	'SAl@U	
sham	SAm	
shame	SEIm	
shampoo	SAm'pu:	
shandy	'SAndi:	
shant	Sa:nt	
shanty	'SAnti:	
shape	SEIp	
share	SE@	
shareholder	'SE@h@Uld@	
shark	Sa:k	
sharp	Sa:p	
sharpener	'Sa:pn@	
shatter	'SAt@	
shave	SEIv	
shaw	So:	
shawl	So:l	
shear	SI@	
shed	SEd	
sheep	Si:p	
sheepish	'Si:pIS	
sheer	SI@	
sheet	Si:t	
shelf	SElf	
shell	SEl	
shellfish	'SElfIS	
shelter	'SElt@	
shelve	SElv	
shelving	'SElvIN	
shield	Si:ld	
shift	SIft	
shifty	'SIfti:	
shimmer	'SIm@	
shin	SIn	
shine	Sa:In	
shingle	SINɡ@l	
ship	SIp	
shipment	'SIpm@nt	
shipshape	'SIpSEIp	
shirk	S@:k	
shirt	S@:t	
shishkebab	'SISk@bAb	
shit	SIt	
shiver	'SIv@	
shock	SOk	
shoddy	'SOdi:	
shoe	Su:	
shone	SOn	
shook	SUk	
shoot	Su:t	
shop	SOp	
shopassistant	'SOp@sIst@nt	
shopsteward	SOp'stju:@d	
shopkeeper	'SOpki:p@	
shoplift	'SOplIft	
shore	So:	
shorn	So:n	
short	So:t	
short-sighted	So:t-'sa:It@d	
short-tempered	So:t-'tEmp@d	
shortage	'So:tIdZ	
shortcoming	'So:tkamIN	
shortcut	So:tkat	
shorten	'So:t@n	
shorthand	'So:thAnd	
shortly	'So:tli:	
shot	SOt	
shotgun	SOtɡan	
should	SUd	
shoulder	'S@Uld@	
shout	Sa:Ut	
shove	Sav	
shovel	'Sav@l	
show	S@U	
show-off	'S@U-Of	
showdown	'S@Uda:Un	
shower	'Sa:U@	
showy	'S@Ui:	
shred	SrEd	
shrewd	Sru:d	
shriek	Sri:k	
shrill	SrIl	
shrimp	SrImp	
shrink	SrINk	
shrivel	'SrIv@l	
shrub	Srab	
shrug	Sraɡ	
shudder	'Sad@	
shuffle	'Saf@l	
shun	San	
shut	Sat	
shutter	'Sat@	
shy	Sa:I	
sibling	'sIblIN	
sick	sIk	
sicken	'sIk@n	
sickening	'sIk@nIN	
sickie	'sIki:	
sickly	'sIkli:	
sickness	'sIkn@s	
side	sa:Id	
side-effects	'sa:Id-@fEkts	
sideshow	'sa:IdS@U	
sideways	'sa:IdwEIz	
siege	si:dZ	
siesta	si:'Est@	
sieve	sIv	
sift	'sIft	
sigh	sa:I	
sight	sa:It	
sightseeing	'sa:Itsi:IN	
sign	sa:In	
signal	sIɡn@l	
signature	sIɡn@tS@	
significant	sIɡ'nIf@k@nt	
silence	'sa:Il@ns	
silk	sIlk	
silkworm	'sIlkw@:m	
sill	sIl	
silly	'sIli:	
silver	'sIlv@	
similar	'sIm@l@	
simmer	'sIm@	
simple	'sImp@l	
simple-minded	'sImp@l-ma:Ind@d	
simply	'sImpli:	
simultaneous	sIm@l'tEIni:@s	
sin	sIn	
since	sIns	
sincere	sIn'sI@	
sincerely	sIn'sI@li:	
sing	sIN	
singe	sIndZ	
single	sINɡ@l	
single-handed	sINɡ@l-'hAnd@d	
single-minded	sINɡ@l-'ma:Ind@d	
singlet	'sINl@t	
singsong	'sINsON	
singular	sINɡj@l@	
sinister	'sIn@st@	
sink	sINk	
sinker	'sINk@	
sinus	'sa:In@s	
sinusitis	sa:In@'sa:It@s	
sip	sIp	
sir	s@:	
siren	'sa:Ir@n	
sissy	'sIsi:	
sister	'sIst@	
sister-in-law	'sIst@r-In-lo:	
sit	sIt	
sit-in	'sIt-In	
sitcom	'sItkOm	
site	sa:It	
sitter	'sIt@	
sittingroom	'sItINru:m	
situated	'sItSu:EIt@d	
situation	sItSu:'EIS@n	
six	sIks	
sixteen	sIks'ti:n	
sixteenth	sIks'ti:nT	
sixth	sIksT	
sixty	'sIksti:	
size	sa:Iz	
sizeable	'sa:Iz@b@l	
sizzle	'sIz@l	
skate	skEIt	
skein	skEIn	
skeleton	'skEl@t@n	
sketch	skEtS	
sketchy	'skEtSi:	
skewer	'skju:@	
ski	ski:	
skid	skId	
skilful	'skIlf@l	
skill	skIl	
skim	skIm	
skimp	skImp	
skimpy	'skImpi:	
skin	skIn	
skinny	'skIni:	
skip	skIp	
skirt	sk@:t	
skivvy	'skIvi:	
skull	skal	
sky	ska:I	
skyscraper	'ska:IskrEIp@	
slab	slAb	
slack	slAk	
slacken	'slAk@n	
slam	slAm	
slammer	'slAm@	
slander	'slAnd@	
slang	slAN	
slant	slAnt	
slap	slAp	
slapdash	'slApdAS	
slapstick	'slApstIk	
slash	slAS	
slat	slAt	
slate	slEIt	
slaughter	'slo:t@	
slave	slEIv	
slay	slEI	
sleazy	'sli:zi:	
sledge	slEdZ	
sledgehammer	'slEdZhAm@	
sleek	sli:k	
sleep	sli:p	
sleeve	sli:v	
slender	'slEnd@	
slice	sla:Is	
slick	slIk	
slide	sla:Id	
slight	sla:It	
slim	slIm	
slime	sla:Im	
sling	slIN	
slink	slINk	
slinky	'slINki:	
slip	slIp	
slippers	'slIp@z	
slippery	'slIp@ri:	'slIpri:
slipperydip	'slIpri:dIp	
slit	slIt	
slob	slOb	
slobber	'slOb@	
slog	slOɡ	
slogan	sl@Uɡ@n	
slop	slOp	
slope	sl@Up	
sloppy	'slOpi:	
sloppyjoe	slOpi:'dZ@U	
slosh	slOS	
sloshed	slOSt	
slot	slOt	
slouch	sla:UtS	
slovenly	'slav@nli:	
slow	sl@U	
sludge	sladZ	
slug	slaɡ	
sluggish	slaɡIS	
slum	slam	
slump	slamp	
slung	slaN	
slur	sl@:	
slurp	sl@:p	
slush	slaS	
slut	slat	
sly	sla:I	
smack	smAk	
small	smo:l	
smallgoods	smo:lɡUdz	
smallpox	'smo:lpOks	
smart	sma:t	
smash	smAS	
smear	smI@	
smell	smEl	
smelt	smElt	
smelter	'smElt@	
smile	sma:Il	
smirk	sm@:k	
smithereens	smID@'ri:nz	
smog	smOɡ	
smoke	sm@Uk	
smokescreen	'sm@Ukskri:n	
smooth	smu:D	
smorgasbord	'smo:ɡ@sbo:d	
smother	'smaD@	
smoulder	'sm@Uld@	
smudge	smadZ	
smug	smaɡ	
smuggle	smaɡ@l	
snack	snAk	
snag	snAɡ	
snail	snEIl	
snake	snEIk	
snap	snAp	
snappy	'snApi:	
snapshot	'snApSOt	
snarl	sna:l	
snatch	snAtS	
sneak	sni:k	
sneer	snI@	
sneeze	sni:z	
sniff	snIf	
sniffle	'snIf@l	
snigger	snIɡ@	
snip	snIp	
snipe	sna:Ip	
snivel	'snIv@l	
snob	snOb	
snooker	'snu:k@	
snoop	snu:p	
snooty	'snu:ti:	
snooze	snu:z	
snore	sno:	
snorkel	'sno:k@l	
snort	sno:t	
snout	sna:Ut	
snow	sn@U	
snub	snab	
snug	snaɡ	
snuggle	snaɡ@l	
so	s@U	
so-and-so	's@U-@n-s@U	
soak	s@Uk	
soap	s@Up	
soar	so:	
sob	sOb	
sober	's@Ub@	
soccer	'sOk@	
social	's@US@l	
socialsecurity	s@US@ls@'kju:r@ti:	
socialise	's@US@la:Iz	
socialism	's@US@lIz@m	
society	s@'sa:I@ti:	
sociology	s@Usi:'Ol@dZi:	
sock	sOk	
socket	'sOk@t	
soda	's@Ud@	
sodium	's@Udi:@m	
sodiumbicarbonate	's@Udi:@mba:I'ka:b@n@t	
sofa	's@Uf@	
sofabed	's@Uf@bEd	
soft	sOft	
soggy	sOɡi:	
soil	so:Il	
solar	's@Ul@	
sold	s@Uld	
soldier	's@UldZ@	
sole	s@Ul	
solemn	'sOl@m	
solicitor	s@'lIs@t@	
solid	'sOl@d	
solitary	'sOl@tri:	
solo	's@Ul@U	
soloist	's@Ul@U@st	
soluble	'sOlj@b@l	
solution	s@'lu:S@n	
solve	sOlv	
sombre	'sOmb@	
some	sam	
somebody	'sambOdi:	
somehow	'samha:U	
someone	'samwan	
somersault	'sam@sOlt	
something	'samTIN	
sometime	'samta:Im	
sometimes	'samta:Imz	
somewhere	'samwE@	
son	san	
son-in-law	'san-In-lo:	
song	sON	
soon	su:n	
soot	sUt	
soothe	su:D	
sophisticated	s@'fIst@kEIt@d	
sopping	'sOpIN	
soprano	s@'pra:n@U	
sorbet	'so:bEI	
sordid	'so:d@d	
sore	so:	
sorrow	'sOr@U	
sorry	'sOri:	
sort	so:t	
souffle	'su:flEI	
sought	so:t	
soul	s@Ul	
sound	sa:Und	
soup	su:p	
sour	'sa:U@	
source	so:s	
south	sa:UT	
southerncross	saD@n'krOs	
souvenir	su:v@'nI@	
soviet	's@Uvi:@t	
sow	s@U	sa:U
soyabean	'so:I@bi:n	
soyasauce	'so:I@so:s	
spa	spa:	
space	spEIs	
spacecraft	'spEIskra:ft	
spacious	'spEIS@s	
spade	spEId	
spaghetti	sp@'ɡEti:	
span	spAn	
spanish	'spAnIS	
spank	spANk	
spanner	'spAn@	
spare	spE@	
spark	spa:k	
sparkplug	spa:kplaɡ	
sparkle	'spa:k@l	
sparse	spa:s	
spasm	'spAz@m	
spasmodic	spAz'mOdIk	
spastic	'spAstIk	
speak	spi:k	
speaker	'spi:k@	
spear	spI@	
special	'spES@l	
specialise	'spES@la:Iz	
specialised	'spES@la:Izd	
specialist	'spES@l@st	
specially	'spES@li:	
species	'spi:si:z	
specific	sp@'sIfIk	
specification	spEs@f@'kEIS@n	
specify	'spEs@fa:I	
specimen	'spEs@m@n	
speck	spEk	
spectacle	'spEkt@k@l	
spectacles	'spEkt@k@lz	
spectacular	spEk'tAkj@l@	
spectator	'spEktEIt@	
spectrum	'spEktr@m	
speculate	'spEkj@lEIt	
sped	spEd	
speech	spi:tS	
speed	spi:d	
speedometer	spi:'dOm@t@	
spell	spEl	
spelt	spElt	
spencer	spEns@	
spend	spEnd	
spendthrift	'spEndTrIft	
sperm	sp@:m	
spew	spju:	
sphere	sfI@	
spice	spa:Is	
spider	'spa:Id@	
spike	spa:Ik	
spiky	spa:Iki:	
spill	spIl	
spin	spIn	
spindrier	spIn'dra:I@	
spin-dry	spIn-'dra:I	
spine	spa:In	
spineless	'spa:Inl@s	
spinnaker	'spIn@k@	
spinningwheel	'spInINwi:l	
spinster	'spInst@	
spiny	'spa:Ini:	
spinyanteater	spa:Ini:'Anti:t@	
spiral	'spa:Ir@l	
spire	'spa:I@	
spirit	'spIr@t	
spiritual	'spIr@tS@l	
spit	spIt	
spite	spa:It	
spiteful	'spa:ItfUl	
splash	splAS	
splatter	'splAt@	
spleen	spli:n	
splendid	'splEnd@d	
splint	splInt	
splinter	'splInt@	
split	splIt	
split-level	'splIt-lEv@l	
splutter	'splat@	
spoil	spo:Il	
spoke	sp@Uk	
spoken	'sp@Uk@n	
spokesperson	'sp@Uksp@:s@n	
sponge	spandZ	
sponsor	'spOns@	
sponsorship	'spOns@SIp	
spontaneous	spOn'tEIni:@s	
spook	spu:k	
spooky	'spu:ki:	
spoon	spu:n	
sporadic	sp@'rAdIk	
sport	spo:t	
sports	spo:ts	
spot	spOt	
spotless	'spOtl@s	
spotted	'spOt@d	
spotty	'spOti:	
spouse	spa:Us	
spout	spa:Ut	
sprain	sprEIn	
sprang	sprAN	
sprawl	spro:l	
spray	sprEI	
spread	sprEd	
spree	spri:	
spring	sprIN	
spring-clean	sprIN-'kli:n	
sprinkle	'sprINk@l	
sprinkler	'sprINkl@	
sprint	sprInt	
sprout	spra:Ut	
sprouts	spra:Uts	
sprung	spraN	
spud	spad	
spun	span	
spur	sp@:	
spurt	sp@:t	
spy	spa:I	
squabble	'skwOb@l	
squad	skwOd	
squalid	'skwOl@d	
squander	'skwOnd@	
square	skwE@	
squash	skwOS	
squeak	skwi:k	
squeal	skwi:l	
squeeze	skwi:z	
squint	skwInt	
squirm	skw@:m	
squirt	skw@:t	
stab	stAb	
stable	'stEIb@l	
stack	stAk	
stadium	'stEIdi:@m	
staff	sta:f	
stage	stEIdZ	
stagger	stAɡ@	
stagnant	stAɡn@nt	
stain	stEIn	
stair	stE@	
staircase	'stE@kEIs	
stake	stEIk	
stale	stEIl	
stalk	sto:k	
stall	sto:l	
stamina	'stAm@n@	
stammer	'stAm@	
stamp	stAmp	
stampduty	'stAmpdju:ti:	
stampede	stAm'pi:d	
stand	stAnd	
stand-by	'stAnd-ba:I	
standard	'stAnd@d	
standing	'stAndIN	
standstill	'stAndstIl	
staple	'stEIp@l	
stapler	'stEIpl@	
star	sta:	
starch	sta:tS	
stare	stE@	
stark	sta:k	
start	sta:t	
startle	'sta:t@l	
starve	sta:v	
state	stEIt	
statement	'stEItm@nt	
static	'stAtIk	
station	stEIS@n	
stationwagon	stEIS@nwAɡ@n	
stationary	'stEIS@nri:	
stationery	'stEIS@nri:	
statistics	st@'tIstIks	
statue	'stAtSu:	
status	'stEIt@s	
statute	'stAtSu:t	
statutorydeclaration	'stAtS@tri:dEkl@'rEIS@n	
stay	stEI	
std	Esti:'di:	
steadfast	'stEdfa:st	
steady	'stEdi:	
steak	stEIk	
steal	sti:l	
steam	sti:m	
steel	sti:l	
steep	sti:p	
steeple	sti:p@l	
steer	stI@	
steeringwheel	'stI@rINwi:l	
stem	stEm	
stenographer	st@'nOɡr@f@	
step	stEp	
stepfather	'stEpfa:D@	
stepladder	'stEplAd@	
stepmother	'stEpmaD@	
stereo	'stEri:@U	
sterile	'stEra:Il	
sterilise	'stEr@la:Iz	
stern	st@:n	
stethoscope	'stET@sk@Up	
stew	stju:	
steward	'stju:@d	
stick	stIk	
sticker	'stIk@	
sticky	'stIki:	
stiff	stIf	
stigma	stIɡm@	
still	stIl	
stimulant	'stImj@l@nt	
stimulate	'stImj@lEIt	
sting	stIN	
stingy	'stIndZi:	
stink	stINk	
stir	st@:	
stitch	stItS	
stock	stOk	
stockexchange	'stOkEkstSEIndZ	
stocking	'stOkIN	
stockman	'stOkm@n	
stocky	'stOki:	
stole	st@Ul	
stolen	'st@Ul@n	
stomach	'stam@k	
stone	st@Un	
stone-cold	st@Un-'k@Uld	
stood	stUd	
stool	stu:l	
stoop	stu:p	
stop	stOp	
stopover	'stOp@Uv@	
stopper	'stOp@	
storage	'sto:rIdZ	
store	sto:	
storey	sto:ri:	
storm	sto:m	
story	'sto:ri:	
stout	sta:Ut	
stove	st@Uv	
straggle	'strAɡ@l	
straight	strEIt	
straightaway	strEIt@'wEI	
straightforward	strEIt'fo:w@d	
strain	strEIn	
strained	strEInd	
strand	strAnd	
strange	strEIndZ	
stranger	'strEIndZ@	
strangle	'strANɡ@l	
strap	strAp	
strategic	str@'ti:dZIk	
strategy	'strAt@dZi:	
straw	stro:	
stray	strEI	
streak	stri:k	
stream	stri:m	
streamer	'stri:m@	
street	stri:t	
strength	strENT	'strENkT
strenuous	'strEnju:@s	
stress	strEs	
stretch	strEtS	
stricken	'strIk@n	
strict	strIkt	
stride	stra:Id	
strife	stra:If	
strike	stra:Ik	
striking	'stra:IkIN	
string	strIN	
strip	strIp	
stripe	stra:Ip	
stripper	'strIp@	
strive	stra:Iv	
strode	str@Ud	
stroke	str@Uk	
stroll	str@Ul	
stroller	'str@Ul@	
strong	strON	
strove	str@Uv	
struck	strak	
structure	'straktS@	
struggle	straɡ@l	
stub	stab	
stubborn	'stab@n	
stubby	'stabi:	
stuck	stak	
stuck-up	'stak-ap	
student	'stju:d@nt	
studio	'stju:di:@U	
study	'stadi:	
stuff	staf	
stuffing	'stafIN	
stuffy	'stafi:	
stumble	'stamb@l	
stump	stamp	
stumpy	'stampi:	
stun	stan	
stung	staN	
stunning	'stanIN	
stupid	'stju:p@d	
sturdy	'st@:di:	
stutter	'stat@	
style	sta:Il	
stylish	'sta:IlIS	
subdivide	'sabd@va:Id	
subdue	s@b'dju:	
subdued	s@b'dju:d	
subject	'sabdZEkt	
submarine	'sabm@ri:n	
submerge	s@b'm@:dZ	
submit	s@b'mIt	
subordinate	s@'bo:d@n@t	
subscribe	s@b'skra:Ib	
subscriber	s@b'skra:Ib@	
subscription	s@b'skrIpS@n	
subsequent	'sabs@kw@nt	
subside	s@b'sa:Id	
subsidiary	s@b'sIdZ@ri:	
subsidy	'sabs@di:	
substance	'sabst@ns	
substantial	s@b'stAnS@l	
substitute	'sabst@tSu:t	
subtitle	'sabta:It@l	
subtle	'sat@l	
subtract	s@b'trAkt	
suburb	'sab@:b	
suburbia	s@'b@:bi:@	
succeed	s@k'si:d	
success	s@k'sEs	
such	satS	
suck	sak	
sudden	'sad@n	
suds	sadz	
sue	su:	
suede	swEId	
suffer	'saf@	
suffering	'saf@rIN	
sufficient	s@'fIS@nt	
suffix	'safIks	
suffocate	'saf@kEIt	
sugar	SUɡ@	
suggest	s@'dZEst	
suicidal	su:@'sa:Id@l	
suicide	'su:@sa:Id	
suit	su:t	
suitable	'su:t@b@l	
suitcase	'su:tkEIs	
suite	swi:t	
suited	'su:t@d	
sulk	salk	
sullen	'sal@n	
sultana	sal'ta:n@	
sultry	'saltri:	
sum	sam	
summary	'sam@ri:	
summer	'sam@	
summit	'sam@t	
summon	'sam@n	
summons	'sam@nz	
sumptuous	'samptSu:@s	
sun	san	
sunbake	'sanbEIk	
sunburn	'sanb@:n	
sunday	'sandEI	
sundry	'sandri:	
sung	saN	
sunglasses	sanɡla:s@z	
sunk	saNk	
sunken	'saNk@n	
sunlight	'sanla:It	
sunny	'sani:	
sunrise	'sanra:Iz	
sunscreen	'sanskri:n	
sunset	'sansEt	
sunshine	'sanSa:In	
sunstroke	'sanstr@Uk	
suntan	'santAn	
super	'su:p@	
superannuation	su:p@rAnju:'EIS@n	
superb	s@'p@:b	
superficial	su:p@'fIS@l	
superintendent	su:p@rIn'tEnd@nt	
superior	s@'pI@ri:@	
superlative	s@'p@:l@tIv	
supermarket	'su:p@ma:k@t	
superstitious	su:p@'stIS@s	
supervise	'su:p@va:Iz	
supper	'sap@	
supple	'sap@l	
supplement	'sapl@m@nt	
supply	s@'pla:I	
support	s@'po:t	
supportive	s@'po:tIv	
suppose	s@'p@Uz	
supposed	s@'p@Uzd	
suppress	s@'prEs	
supreme	s@'pri:m	
sure	So:	
surely	'So:li:	
surf	s@:f	
surface	's@:f@s	
surfboard	's@:fbo:d	
surge	s@:dZ	
surgeon	's@:dZ@n	
surgery	's@:dZ@ri:	
surly	's@:li:	
surname	's@:nEIm	
surpass	s@'pa:s	
surplus	's@:pl@s	
surprise	s@'pra:Iz	
surrender	s@'rEnd@	
surround	s@'ra:Und	
surroundings	s@'ra:UndINz	
survey	s@'vEI	's@:vEI
surveyor	s@'vEI@	
survive	s@'va:Iv	
suspect	s@'spEkt	
suspend	s@'spEnd	
suspense	s@'spEns	
suspension	s@'spEnS@n	
suspicion	s@'spIS@n	
suspicious	s@'spIS@s	
suss	sas	
sustain	s@'stEIn	
swag	swAɡ	
swagger	swAɡ@	
swallow	'swOl@U	
swam	swAm	
swamp	swOmp	
swap	swOp	
swarm	swo:m	
swarthy	'swo:Di:	
swat	swOt	
sway	swEI	
swear	swE@	
sweat	swEt	
sweater	'swEt@	
sweep	swi:p	
sweeping	'swi:pIN	
sweet	swi:t	
sweeten	'swi:t@n	
sweetheart	'swi:tha:t	
swell	swEl	
swelling	'swElIN	
swept	swEpt	
swerve	sw@:v	
swift	swIft	
swim	swIm	
swimmers	'swIm@z	
swimmingpool	'swImINpu:l	
swimsuit	'swImsu:t	
swindle	'swInd@l	
swing	swIN	
swipe	swa:Ip	
switch	swItS	
switchboard	'swItSbo:d	
swollen	'sw@Ul@n	
swoop	swu:p	
sword	so:d	
swore	swo:	
sworn	swo:n	
swum	swam	
swung	swaN	
sycamore	sIk@mo:	
syllable	'sIl@b@l	
syllabus	'sIl@b@s	
symbol	'sImb@l	
symmetry	'sIm@tri:	
sympathy	'sImp@Ti:	
symphony	'sImf@ni:	
symptom	'sImpt@m	
synagogue	sIn@ɡOɡ	
syndicate	'sInd@k@t	'sIndIk@t
synonym	'sIn@nIm	
synopsis	s@'nOps@s	
synthetic	sIn'TEtIk	
syringe	s@'rIndZ	
syrup	'sIr@p	
system	'sIst@m	
t	ti:	
t-shirt	'ti:-S@:t	
ta	ta:	
tab	tAb	
tabby	'tAbi:	
table	'tEIb@l	
tabletennis	'tEIb@ltEn@s	
tablecloth	'tEIb@lklOT	
tablespoon	'tEIb@lspu:n	
tablet	'tAbl@t	
tableware	'tEIb@lwE@	
tabloid	'tAblo:Id	
taboo	t@'bu:	
tabulate	'tAbj@lEIt	
tacit	'tAs@t	
taciturn	'tAs@t@:n	
tack	tAk	
tackle	'tAk@l	
tacky	'tAki:	
tact	tAkt	
tactic	'tAktIk	
tactics	'tAktIks	
tafe	tEIf	
tag	tAɡ	
tail	tEIl	
tailor	'tEIl@	
taipan	'ta:IpAn	
take	tEIk	
take-off	'tEIk-Of	
takeaway	'tEIk@wEI	
takings	'tEIkINz	
talcumpowder	'tAlk@mpa:Ud@	
tale	tEIl	
talent	'tAl@nt	
talk	to:k	
talkback	'to:kbAk	
tall	to:l	
tally	'tAli:	
talon	'tAl@n	
tame	tEIm	
tamper	'tAmp@	
tampon	'tAmpOn	
tan	tAn	
tandem	'tAnd@m	
tang	tAN	
tangent	'tAndZ@nt	
tangerine	tAndZ@'ri:n	
tangible	'tAndZ@b@l	
tangle	tANɡ@l	
tank	tANk	
tankard	'tANk@d	
tanker	'tANk@	
tantalise	'tAnt@la:Iz	
tantamount	'tAnt@ma:Unt	
tantrum	'tAntr@m	
tap	tAp	
tape	tEIp	
tape-recorder	'tEIp-r@ko:d@	
taper	'tEIp@	
tapestry	'tAp@stri:	
tar	ta:	
target	'ta:ɡ@t	
tariff	'tAr@f	
tarmac	'ta:mAk	
tarnish	'ta:nIS	
tarpaulin	ta:'po:l@n	
tarragon	tAr@ɡ@n	
tart	ta:t	
tartan	'ta:t@n	
tas	tAz'mEInj@	
task	ta:sk	
tassel	'tAs@l	
taste	tEIst	
tasteful	'tEIstfUl	
tasteless	'tEIstl@s	
tasty	'tEIsti:	
tattered	'tAt@d	
tatters	'tAt@z	
tattoo	tA'tu:	
tatty	'tAti:	
taught	to:t	
taunt	to:nt	
taut	to:t	
tautology	to:'tOl@dZi:	
tavern	'tAv@n	
tawdry	'to:dri:	
tawny	'to:ni:	
tax	tAks	
taxi	'tAksi:	
tea	ti:	
teatowel	'ti:ta:Ul	
teabag	ti:bAɡ	
teach	ti:tS	
teacher	'ti:tS@	
teachersaide	'ti:tS@zEId	
team	ti:m	
teapot	'ti:pOt	
tear	tI@	
tease	ti:z	
teaspoon	'ti:spu:n	
teat	ti:t	
tech	tEk	
technical	'tEknIk@l	
technicalcollege	'tEknIk@lkOlIdZ	
technician	tEk'nIS@n	
technique	tEk'ni:k	
technology	tEk'nOl@dZi:	
teddybear	'tEdi:bE@	
tedious	'ti:di:@s	
tee	ti:	
teem	ti:m	
teenager	'ti:nEIdZ@	
teens	ti:nz	
teeth	ti:T	
teetotal	'ti:t@Ut@l	
telecast	'tEl@ka:st	
telecommunications	tEl@k@mju:n@'kEIS@nz	
telepathy	t@'lEp@Ti:	
telephone	'tEl@f@Un	
telephoneexchange	'tEl@f@UnEks'tSEIndZ	
telescope	'tEl@sk@Up	
television	'tEl@vIZ@n	
tell	tEl	
teller	'tEl@	
temper	'tEmp@	
temperament	'tEmpr@m@nt	
temperamental	tEmpr@'mEnt@l	
temperature	'tEmpr@tS@	
temporary	'tEmpri:	
tempt	tEmpt	
ten	tEn	
tenacious	t@'nEIS@s	
tenant	'tEn@nt	
tend	tEnd	
tender	'tEnd@	
tendon	'tEnd@n	
tenement	'tEn@m@nt	
tennis	'tEn@s	
tenor	'tEn@	
tense	tEns	
tent	tEnt	
tentacle	'tEnt@k@l	
tentative	'tEnt@tIv	
tenth	tEnT	
tenuous	'tEnju:@s	
tepid	'tEp@d	
term	t@:m	
terminal	't@:m@n@l	
terminate	't@:m@nEIt	
terminology	t@:m@'nOl@dZi:	
terminus	't@:m@n@s	
termite	't@:ma:It	
terrace	'tEr@s	
terrain	t@'rEIn	
terrestrial	t@'rEstri:@l	
terrible	'tEr@b@l	
terribly	'tEr@bli:	
terrific	t@'rIfIk	
terrify	'tEr@fa:I	
territory	'tEr@tri:	
terror	'tEr@	
terrorise	'tEr@ra:Iz	
terrorism	'tEr@rIz@m	
terse	t@:s	
tertiary	't@:S@ri:	
test	tEst	
testament	'tEst@m@nt	
testicle	'tEstIk@l	
testify	'tEst@fa:I	
testimonial	tEst@'m@Uni:@l	
testimony	'tEst@m@ni:	
tether	'tED@	
text	tEkst	
texta	'tEkst@	
textbook	'tEkstbUk	
textile	'tEksta:Il	
texture	'tEkstS@	
thai	ta:I	
than	DAn	
thank	TANk	
that	DAt	
thatch	TAtS	
thaw	To:	
the	D@	
theatre	TI@t@	
theatrical	Ti:'AtrIk@l	
theft	TEft	
their	DE@	
theirs	DE@z	
them	DEm	
theme	Ti:m	
themselves	D@m'sElvz	
then	DEn	
theology	Ti:'Ol@dZi:	
theorem	'TI@r@m	
theory	'TI@ri:	
therapeutic	TEr@'pju:tIk	
therapy	'TEr@pi:	
there	DE@	
thereabouts	DE@r@'ba:Uts	
thereafter	DE@r'a:ft@	
thereby	DE@'ba:I	
therefore	'DE@fo:	
therell	DE@l	
thereupon	DE@r@'pOn	
thermometer	T@'mOm@t@	
thermos	'T@:mOs	
thermostat	'T@:m@stAt	
thesaurus	T@'so:r@s	
these	Di:z	
thesis	'Ti:s@s	
they	DEI	
thick	TIk	
thicket	'TIk@t	
thief	Ti:f	
thigh	Ta:I	
thimble	'TImb@l	
thin	TIn	
thing	TIN	
think	TINk	
third	T@:d	
thirst	T@:st	
thirteen	T@:'ti:n	
thirteenth	T@:'ti:nT	
thirty	'T@:ti:	
this	DIs	
thistle	'TIs@l	
thong	TON	
thorn	To:n	
thorough	'Tar@	
thoroughfare	'Tar@fE@	
thoroughly	'Tar@li:	
those	D@Uz	
though	D@U	
thought	To:t	
thoughtful	'To:tfUl	
thoughtless	'To:tl@s	
thousand	'Ta:Uz@nd	
thousandth	'Ta:Uz@nT	
thrash	TrAS	
thread	TrEd	
threadbare	'TrEdbE@	
threat	TrEt	
threaten	'TrEt@n	
three	Tri:	
three-dimensional	Tri:d@mEnS@n@l	
thresh	TrES	
threshold	'TrESh@Uld	
threw	Tru:	
thrift	TrIft	
thrifty	TrIfti:	
thrill	TrIl	
thriller	'TrIl@	
thrive	Tra:Iv	
throat	Tr@Ut	
throb	TrOb	
throne	Tr@Un	
throng	TrON	
throttle	'TrOt@l	
through	Tru:	
throughout	Tru:'a:Ut	
throw	Tr@U	
thrust	Trast	
thud	Tad	
thug	Taɡ	
thumb	Tam	
thump	Tamp	
thunder	'Tand@	
thursday	'T@:zdEI	
thus	Das	
thwart	Two:t	
thyme	ta:Im	
thyroid	'Ta:Iro:Id	
tick	tIk	
ticket	'tIk@t	
tickle	'tIk@l	
ticklish	'tIklIS	
tiddly	'tIdli:	
tide	ta:Id	
tidy	'ta:Idi:	
tie	ta:I	
tier	'tI@	
tigersnake	ta:Iɡ@snEIk	
tight	ta:It	
tights	ta:Its	
tile	ta:Il	
till	tIl	
tilt	tIlt	
timber	'tImb@	
time	ta:Im	
timely	'ta:Imli:	
timetable	'ta:ImtEIb@l	
timid	'tIm@d	
tin	tIn	
tinea	'tIni:@	
tinge	tInZ	
tingle	tINɡ@l	
tinker	'tINk@	
tinkle	'tINk@l	
tinnie	'tIni:	
tinny	'tIni:	
tinsel	'tIns@l	
tint	tInt	
tiny	'ta:Ini:	
tip	tIp	
tipsy	'tIpsi:	
tirade	ta:I'rEId	
tire	ta:I@	
tired	ta:I@d	
tiring	'ta:I@rIN	
tissue	'tISu:	
tit	tIt	
titbit	'tItbIt	
title	'ta:It@l	
titter	'tIt@	
to	tu:	
toad	t@Ud	
toadstool	't@Udstu:l	
toast	t@Ust	
toaster	't@Ust@	
tobacco	t@'bAk@U	
toboggan	t@'bOɡ@n	
today	t@'dEI	
toddle	'tOd@l	
toddler	'tOdl@	
toe	t@U	
together	t@'ɡED@	
toil	to:Il	
toilet	'to:Il@t	
toiletries	'to:Il@tri:z	
token	't@Uk@n	
told	t@Uld	
tolerable	'tOlr@b@l	'tOl@r@b@l
tolerant	'tOl@r@nt	
tolerate	'tOl@rEIt	
toll	t@Ul	tOl
tomato	t@'ma:t@U	
tomb	tu:m	
tombstone	'tu:mst@Un	
tomcat	'tOmkAt	
tomorrow	t@'mOr@U	
ton	tan	
tone	t@Un	
tongue	taN	
tonic	'tOnIk	
tonight	t@'na:It	
tonne	tOn	
tonsil	'tOns@l	
tonsilitis	tOns@'la:It@s	
too	tu:	
took	tUk	
tool	tu:l	
toot	tu:t	
tooth	tu:T	
toothache	'tu:TEIk	
toothbrush	'tu:TbraS	
toothpaste	'tu:TpEIst	
toothpick	'tu:TpIk	
top	tOp	
topic	'tOpIk	
topical	'tOpIk@l	
topless	'tOpl@s	
topping	'tOpIN	
topple	'tOp@l	
torch	to:tS	
tore	to:	
torment	'to:mEnt	to:'mEnt
torn	to:n	
tortuous	'to:tSu:@s	
torture	'to:tS@	
toss	tOs	
total	't@Ut@l	
totalitarian	t@U;tAl@'tE@ri:@n	
totem	't@Ut@m	
totter	'tOt@	
touch	tatS	
touchy	'tatSi:	
tough	taf	
tour	tU@	
tourism	'tU@rIs@m	'tu:@rIs@m
tourist	'tU@r@st	'tu:@r@st
tournament	'to:n@m@nt	
tow	t@U	
towards	t@'wo:dz	
towel	'ta:U@l	
tower	ta:U@	
town	ta:Un	
townhall	ta:Un'ho:l	
toxic	'tOksIk	
toxin	'tOks@n	
toy	to:I	
trace	trEIs	
track	trAk	
tracksuit	'trAksu:t	
tractor	'trAkt@	
trade	trEId	
tradeunion	trEId'ju:nj@n	
trade-in	'trEId-In	
trademark	'trEIdma:k	
tradition	tr@'dIS@n	
traffic	'trAfIk	
trafficjam	'trAfIkdZAm	
tragedy	'trAdZ@di:	
tragic	'trAdZIk	
trail	trEIl	
trailer	'trEIl@	
train	trEIn	
trainee	trEI'ni:	
training	'trEInIN	
trait	trEIt	
traitor	'trEIt@	
tram	trAm	
trample	'trAmp@l	
tranquil	'trANkw@l	
tranquilliser	'trANkw@la:Iz@	
transfer	trAns'f@:	'trAnsf@:
transform	trAns'fo:m	
transfusion	trAns'fju:Z@n	
transitive	'trAnz@tIv	
translate	trAnz'lEIt	
transmit	trAnz'mIt	
transparent	trAn'spE@r@nt	
transplant	trAn'splAnt	
transport	'trAnspo:t	
trap	trAp	
trauma	'tro:m@	
travel	'trAv@l	
travelagent	'trAv@lEIdZ@nt	
tray	trEI	
treacherous	'trEtS@r@s	
treachery	'trEtS@ri:	
tread	trEd	
treasure	'trEZ@	
treasurer	'trEZ@r@	
treat	tri:t	
tree	tri:	
tremble	'trEmb@l	
tremendous	tr@'mEnd@s	
trend	trEnd	
trendy	trEndi:	
trespass	'trEsp@s	
trial	tra:I@l	
triangle	'tra:IANɡ@l	
tribunal	tr@'bju:n@l	tra:I'bju:n@l
trick	trIk	
trickle	'trIk@l	
tried	tra:Id	
trim	trIm	
trip	trIp	
triple	'trIp@l	
triumph	'tra:Iamf	
trivial	'trIvi:@l	
trod	trOd	
trodden	'trOd@n	
trolley	'trOli:	
troop	tru:p	
tropical	'trOpIk@l	
tropics	'trOpIks	
trouble	'trab@l	
trousers	'tra:Uz@z	
truck	trak	
trudge	tradZ	
1	tru:	
trumpet	'tramp@t	
trunk	traNk	
trust	trast	
trustworthy	'trastw@:Di:	
truth	tru:T	
truthful	'tru:TfUl	
try	tra:I	
tube	tju:b	'tSu:b
tuck	tak	
tuesday	'tju:zdEI	
tuft	taft	
tug	taɡ	
tuition	tju:'IS@n	tSu:'IS@n
tumble	'tamb@l	
tumour	'tju:m@	
tuna	'tju:n@	
tune	tju:n	
tunnel	tan@l	
turkish	't@:kIS	
turn	t@:n	
turquoise	't@:kwo:Iz	
tutor	'tju:t@	
tv	ti:'vi:	
tweezers	'twi:z@z	
twelfth	twElfT	
twelve	twElv	
twentieth	'twEnti:@T	
twenty	'twEnti:	
twice	twa:Is	
twig	twIɡ	
twilight	'twa:Ila:It	
twin	twIn	
twinge	twIndZ	
twinkle	'twINk@l	
twist	twIst	
two	tu:	
tying	'ta:IIN	
type	ta:Ip	
typewriter	'ta:Ipra:It@	
typhoid	'ta:Ifo:Id	
typhoon	ta:I'fu:n	
typical	'tIpIk@l	
typically	'tIpIkli:	
tyre	ta:I@	
u	ju:	
ugly	aɡli:	
ulcer	'als@	
ultimate	'alt@m@t	
um	am	
umbrella	am'brEl@	
umpire	'ampa:I@	
umpteen	amp'ti:n	
unanimous	ju:'nAn@m@s	
uncanny	an'kAni:	
uncle	'aNk@l	
unconscious	an'kOnS@s	
under	'and@	
underarm	'and@ra:m	
underdone	and@'dan	
undergo	and@'ɡ@U	
undergrowth	'and@ɡr@UT	
underhand	'and@hAnd	
underline	and@'la:In	
underneath	and@'ni:T	
underpants	'and@pAnts	
understand	and@'stAnd	
understate	and@'stEIt	
undertake	and@'tEIk	
undertaker	'and@tEIk@	
underwear	'and@wE@	
undo	an'du:	
uneasy	an'i:zi:	
unemployed	anEm'plo:Id	
uneventful	an@'vEntfUl	
unforgettable	anf@'ɡEt@b@l	
uniform	'ju:n@fo:m	
unify	'ju:n@fa:I	
unilateral	ju:ni:'lAt@r@l	
uninterested	an'Intr@st@d	
union	'ju:nj@n	
unique	ju:'ni:k	
unisex	'ju:ni:sEks	
unison	'ju:n@s@n	
unit	'ju:n@t	
unite	ju:'na:It	
universal	ju:n@'v@:s@l	
universe	'ju:n@v@:s	
university	ju:n@'v@:s@ti:	
unknown	an'n@Un	
unlawful	an'lo:fUl	
unless	an'lEs	
unravel	an'rAv@l	
unreal	an'ri:l	
unrest	an'rEst	
unscathed	an'skEIDd	
unscrew	an'skru:	
unscrupulous	an'skru:pj@l@s	
unsettle	an'sEt@l	
untangle	an'tANɡ@l	
unthinkable	an'TINk@b@l	
untie	an'ta:I	
until	an'tIl	
unusual	an'ju:Zu:@l	
unwieldy	an'wI@ldi:	
up	ap	
up-market	'ap-ma:k@t	
up-to-date	ap-t@-'dEIt	
upbringing	'apbrININ	
update	ap'dEIt	
upgrade	ap'ɡrEId	
upheaval	ap'hi:v@l	
uphill	ap'hIl	
uphold	ap'h@Uld	
upholstery	ap'h@Ulstri:	
upkeep	'apki:p	
upon	@'pOn	
upper	'ap@	
uppermost	'ap@m@Ust	
upright	'apra:It	
uprising	'apra:IzIN	
uproar	'apro:	
uproarious	ap'ro:ri:@s	
upset	ap'sEt	
upsidedown	apsa:Id'da:Un	
upstairs	ap'stE@z	
upstream	ap'stri:m	
uptight	ap'ta:It	
upturn	'apt@:n	
upward	'apw@d	
upwards	'apw@dz	
upwind	ap'wInd	
uranium	ju:'rEIni:@m	
urban	'@:b@n	
urbane	@:'bEIn	
urge	@:dZ	
urgent	'@:dZ@nt	
urinal	'ju:r@n@l	
urine	'ju:r@n	
urn	@:n	
us	as	
use	ju:z	
used	ju:zd	
usual	'ju:Zu:@l	
ute	ju:t	
utensil	ju:'tEns@l	
uterus	'ju:t@r@s	
utilities	ju:'tIl@ti:z	
utilitytruck	ju:'tIl@ti:trak	
utter	'at@	
v	vi:	
vacancy	'vEIk@nsi:	
vacant	'vEIk@nt	
vacation	v@'kEIS@n	vEI'kEIS@n
vaccine	vAk'si:n	
vacuum	'vAkju:m	
vagina	v@'dZa:In@	
vague	vEIɡ	
vain	vEIn	
valid	'vAl@d	
valley	'vAli:	
valuable	'vAlj@b@l	
value	'vAlju:	
valve	vAlv	
van	vAn	
vandal	'vAnd@l	
vanilla	v@'nIl@	
vanish	'vAnIS	
vanity	'vAn@ti:	
vapour	'vEIp@	
variety	v@'ra:I@ti:	
various	'vE@ri:@s	
varnish	'va:nIS	
vary	'vE@ri:	
vase	va:z	
vast	va:st	
vat	vAt	
vcr	vi:si:'a:	
vdu	vi:di:'ju:	
veal	vi:l	
vegan	vi:ɡ@n	
vegetable	'vEdZt@b@l	
vegetarian	vEdZ@'tE@ri:@n	
vegetation	vEdZ@'tEIS@n	
vegie	'vEdZi:	
vehement	'vi:@m@nt	
vehicle	'vI@k@l	
veil	vEIl	
vein	vEIn	
velvet	'vElv@t	
veneer	v@'nI@	
venerealdisease	v@'nI@ri:@ld@zi:z	
vengeance	'vEndZ@ns	
venom	'vEn@m	
ventilate	'vEnt@lEIt	
venture	'vEntS@	
venue	'vEnju:	
veranda	v@'rAnd@	
verb	v@:b	
verbal	'v@:b@l	
verdict	'v@:dIkt	
verify	'vEr@fa:I	
versatile	'v@:s@ta:Il	
verse	v@:s	
version	'v@:Z@n	
versus	'v@:s@z	
vertebra	'v@:t@br@	
vertical	'v@:tIk@l	
very	'vEri:	
vessel	'vEs@l	
vet	vEt	
veto	'vi:t@U	
vex	vEks	
via	'va:I@	
vibrate	va:I'brEIt	
vic	vIk'to:ri:@	
vice	va:Is	
viceversa	va:Is@'v@:s@	
vicinity	v@'sIn@ti:	
vicious	'vIS@s	
victim	'vIkt@m	
victimise	'vIkt@ma:Iz	
victory	'vIkt@ri:	
video	'vIdi:@U	
videotape	'vIdi:@UtEIp	
vietnamese	vi:;Etn@'mi:z	
view	vju:	
viewer	'vju:@	
vigorous	vIɡ@r@s	
vile	va:Il	
village	'vIlIdZ	
villain	'vIl@n	
vindictive	vIn'dIktIv	
vine	va:In	
vinegar	vInIɡ@	
vineyard	'vInj@d	
vintage	'vIntIdZ	
vinyl	'va:In@l	
violent	'va:I@l@nt	
violin	va:I@'lIn	
vip	vi:a:I'pi:	
virgin	'v@:dZ@n	
virile	'vIra:Il	
virtue	'v@:tSu:	
virulent	'vIr@l@nt	
virus	'va:Ir@s	
visa	'vi:z@	
visible	'vIz@b@l	
vision	'vIZ@n	
visit	'vIz@t	
visual	'vIZu:@l	
visualdisplayunit	vIZu:@ld@'splEIju:n@t	
visualise	'vIZj@la:Iz	
vital	'va:It@l	
vitality	va:I'tAl@ti:	
vitamin	'va:It@m@n	
vivacious	v@'vEIS@s	
vivid	'vIv@d	
vocabulary	v@'kAbj@l@ri:	
vocal	'v@Uk@l	
vocalist	'v@Uk@l@st	
vogue	v@Uɡ	
voice	vo:Is	
void	vo:Id	
volcano	vOl'kEIn@U	
volley	'vOli:	
volleyball	'vOli:bo:l	
volume	'vOlju:m	
voluntary	'vOl@ntri:	
volunteer	vOl@n'tI@	
vomit	'vOm@t	
vote	v@Ut	
voucher	'va:UtS@	
vow	va:U	
vowel	'va:U@l	
voyage	'vo:IIdZ	
vs	'v@:s@z	
vulgar	valɡ@	
vulnerable	'valnr@b@l	
w	wEst	'dab@lju:
wa	wEst@n@'strEIlj@	
wad	wOd	
waddle	'wOd@l	
wade	wEId	
wafer	'wEIf@	
wag	wAɡ	
wage	wEIdZ	
wager	'wEIdZ@	
wail	wEIl	
waist	wEIst	
wait	wEIt	
waiter	'wEIt@	
wake	wEIk	
walk	wo:k	
walkover	'wo:k@Uv@	
wall	wo:l	
wallet	'wOl@t	
wallpaper	'wo:lpEIp@	
waltz	wo:ls	wOlts
wander	'wOnd@	
wane	wEIn	
wangle	wANɡ@l	
wank	wANk	
want	wOnt	
war	wo:	
ward	wo:d	
warden	'wo:d@n	
warder	'wo:d@	
wardrobe	'wo:dr@Ub	
warehouse	'wE@ha:Us	
warfare	'wo:fE@	
warm	wo:m	
warn	wo:n	
warning	'wo:nIN	
warp	wo:p	
warped	wo:pt	
warrant	'wOr@nt	
warranty	'wOr@nti:	
wart	wo:t	
wary	'wE@ri:	
was	wOz	
wash	wOS	
washed-out	'wOSt-a:Ut	
washer	'wOS@	
waste	wEIst	
wastepaperbasket	wEIst'pEIp@ba:sk@t	
watch	wOtS	
water	wo:t@	
watercolour	'wo:t@kal@	
waterfront	'wo:t@frant	
waterlogged	wo:t@lOɡd	
waterproof	'wo:t@pru:f	
waterski	'wo:t@ski:	
watertight	'wo:t@ta:It	
watt	wOt	
wattle	wOt@l	
wave	wEIv	
wax	wAks	
way	wEI	
way-out	'wEI-a:Ut	
we	wi:	
weak	wi:k	
wealth	wElT	
wealthy	'wElTi:	
weapon	'wEp@n	
wear	wE@	
weary	'wI@ri:	
weather	'wED@	
weave	wi:v	
web	wEb	
webbed	wEbd	
wedding	'wEdIN	
wedge	wEdZ	
wednesday	'wEnzdEI	
weed	wi:d	
week	wi:k	
weekday	'wi:kdEI	
weekend	wi:k'End	
weekly	'wi:kli:	
weep	wi:p	
weigh	wEI	
weight	wEIt	
weird	wI@d	
welcome	'wElk@m	
weld	wEld	
welfare	'wElfE@	
well	wEl	
well-off	wEl-'Of	
wellbeing	'wElbi:IN	
went	wEnt	
wept	wEpt	
were	w@:	
werent	w@:nt	
west	wEst	
western	'wEst@n	
wet	wEt	
whack	wAk	
wharf	wo:f	
what	wOt	
whatever	wOt'Ev@	
whatsoever	wOts@U'Ev@	
wheat	wi:t	
wheel	wi:l	
wheelbarrow	'wi:lbAr@U	
wheelchair	'wi:ltSE@	
when	wEn	
whenever	wEn'Ev@	
where	wE@	
whereabouts	'wE@r@ba:Uts	
whereas	wE@r'Az	
wherever	wE@r'Ev@	
whether	'wED@	
which	wItS	
whiff	wIf	
while	wa:Il	
whim	wIm	
whimper	'wImp@	
whine	wa:In	
whinge	wIndZ	
whip	wIp	
whirl	w@:l	
whirlwind	'w@:lwInd	
whirr	w@:	
whisk	wIsk	
whisker	'wIsk@	
whisky	'wIski:	
whisper	'wIsp@	
whistle	'wIs@l	
white	wa:It	
whiteant	'wa:ItAnt	
white-ant	'wa:ItAnt	
white-out	'wa:Ita:Ut	
whitewash	'wa:ItwOS	
whiz	wIz	
who	hu:	
whoever	hu:'Ev@	
whole	h@Ul	
wholemeal	'h@Ulmi:l	
wholesale	'h@UlsEIl	
wholesome	'h@Uls@m	
whom	hu:m	
whopping	'wOpIN	
whore	ho:	
whose	hu:z	
why	wa:I	
wick	wIk	
wicked	'wIk@d	
wicket	'wIk@t	
wide	wa:Id	
widespread	'wa:IdsprEd	
widow	'wId@U	
widower	'wId@U@	
wife	wa:If	
wig	wIɡ	
wiggle	wIɡ@l	
wild	wa:Ild	
wildflower	'wa:Ildfla:U@	
wilderness	'wIld@n@s	
wildlife	'wa:Ildla:If	
wilful	'wIlf@l	
will	wIl	
willing	'wIlIN	
willpower	'wIlpa:U@	
wilt	wIlt	
wily	'wa:Ili:	
wimp	wImp	
win	wIn	
wince	wIns	
wind	wInd	wa:Ind
window	'wInd@U	
windowshopping	'wInd@U;SOpIN	
windows	wInd@Uz	
windowsill	'wInd@UsIl	
windpipe	'wIndpa:Ip	
windscreen	'wIndskri:n	
windsurf	'wInds@:f	
windy	'wIndi:	
wine	wa:In	
wing	wIN	
wink	wINk	
winning	'wInIN	
winter	'wInt@	
wipe	wa:Ip	
wire	'wa:I@	
wiry	'wa:I@ri:	
wisdomtooth	'wIzd@mtu:T	
wise	wa:Iz	
wish	wIS	
wishy-washy	'wISi:-wOSi:	
wit	wIt	
witch	wItS	
with	wIT	
withdraw	wID'dro:	wIT'dro:
withhold	wID'h@Uld	wIT'h@Uld
within	wID'In	
without	wID'a:Ut	
witness	'wItn@s	
wizard	'wIz@d	
wobble	'wOb@l	
woe	w@U	
woeful	'w@UfUl	
wog	wOɡ	
wok	wOk	
woke	w@Uk	
wolf	wUlf	
woman	'wUm@n	
womb	wu:m	
wombat	'wOmbAt	
won	wan	
wonder	'wand@	
wonderful	'wand@fUl	
wood	wUd	
wooden	wUd@n	
woodwork	'wUdw@:k	
wool	wUl	
word	w@:d	
wordprocessor	'w@:dpr@UsEs@	
wore	wo:	
work	w@:k	
workbench	'w@:kbEntS	
workforce	'w@:kfo:s	
workload	'w@:kl@Ud	
workout	'w@:ka:Ut	
workplace	'w@:kplEIs	
workshop	'w@:kSOp	
world	w@:ld	
worldwide	w@:l'dwa:Id	
worm	w@:m	
worn	wo:n	
worn-out	wo:n-'a:Ut	
worry	'wari:	
worse	w@:s	
worship	'w@:SIp	
worst	w@:st	
worth	w@:T	
worthwhile	w@:T'wa:Il	
worthy	'w@:Di:	
would	wUd	
wound	wa:Und	wu:nd
woven	'w@Uv@n	
wow	wa:U	
wowser	'wa:Uz@	
wrap	rAp	
wreath	ri:T	
wreck	rEk	
wrestle	'rEs@l	
wretch	rEtS	
wriggle	'rIɡ@l	
wring	rIN	
wrinkle	'rINk@l	
wrist	rIst	
write	ra:It	
write-off	'ra:It-Of	
wrong	rON	
wrote	r@Ut	
wrung	raN	
wuss	wUs	
x	Eks	
x-ray	'Eks-rEI	
xmas	'krIsm@s	
y	wa:I	
yacht	jOt	
yak	jAk	
yakka	'jAk@	
yank	jANk	
yap	jAp	
yard	ja:d	
yarn	ja:n	
yawn	jo:n	
yd	ja:d	
yeah	jE@	
year	jI@	
yeast	ji:st	
yell	jEl	
yellow	jEl@U	
yelp	jElp	
yen	jEn	
yes	jEs	
yesterday	'jEst@dEI	
yet	jEt	
yield	ji:ld	
yoga	j@Uɡ@	
yoghurt	j@Uɡ@t	
yolk	j@Uk	
yonks	jONks	
you	ju:	
young	jaN	
youngster	'jaNst@	
your	jo:	
yours	jo:z	
yourself	jo:'sElf	
youth	ju:T	
yr	jI@	
yuk	jak	
yuppie	'japi:	
z	zEd	
zeal	zi:l	
zero	'zI@r@U	
zest	zEst	
zigzag	zIɡzAɡ	
zinc	zINk	
zip	zIp	
zodiac	'z@Udi:Ak	
zombie	'zOmbi:	
zone	z@Un	
zoo	zu:	
zoology	z@U'Ol@dZi:	
zoom	zu:m	
zucchini	z@'ki:ni:	
